{
  "name": "The Long Crossing",
  "objective": "Cross the frontier west to east — raise the relay pylons to wake the dormant Anchor",
  "time": 720,
  "expedition": true,
  "captiveChars": [
    "volt",
    "raider",
    "sniper",
    "atlas",
    "bastion",
    "duelist",
    "shade",
    "pyro"
  ],
  "npcs": [
    {
      "id": "doc-aroyo",
      "name": "Doc Aroyo",
      "lines": [
        "Hold still — there. Good as before the Fall. Almost.",
        "This keep held three nightwaves. The garrison didn't. I stayed for the patients.",
        "Hm, hm-hmm... sorry. Old transit jingle. The lines will run again once the Anchor settles.",
        "A barricade and a working turret would do more for my patients than I ever could.",
        "Watch the Leeches out east. Unsealed shards feed them fat."
      ]
    },
    {
      "id": "wrenna-halv",
      "name": "Wrenna Halv",
      "lines": [
        "Operator on your feet — good. The Anchor east of here is dormant. Cold since the Fall.",
        "Three relay pylons feed it. All three online or the gate stays cold — quorums don't negotiate.",
        "Pylons take LYTH. The Entropy drops shards when it falls — kill it, take them, build.",
        "Crystal nodes grow along the road. Crack them open; unsealed LYTH helps nobody but the Leeches.",
        "People lie. Quorums don't. Get my pylons up and we all go home."
      ],
      "gift": {
        "shards": 6
      }
    },
    {
      "id": "cassio-bell",
      "name": "Cassio 'Quorum' Bell",
      "lines": [
        "Three pylons for one gate. Counted twice on my fingers. I don't like the odds.",
        "I don't run jobs under seven-in-ten. This lane? Coin flip. That's why I'm sitting down.",
        "Nightwave took the last courier through here. Keep to the fires, operator.",
        "Forklings in the trees. See one, there are already two. That's how forks work."
      ]
    },
    {
      "id": "old-tarn",
      "name": "Old Tarn",
      "lines": [
        "Stranded two seasons in this muck. Thought nobody kept the signal.",
        "Here — shards I pulled before my lantern drowned. The LYTH remembers who carried it. It remembers me fondly.",
        "Shiny mud is slow mud. Walk the causeway, not the sheen.",
        "A Phantom past the ridge wears an operator's coat. It is not an operator. Burn anything classical it offers.",
        "Settle the Anchor. Once it settles, that's finality — even out here."
      ],
      "gift": {
        "shards": 4
      }
    }
  ],
  "builds": [
    {
      "kind": "barricade",
      "cost": 4
    },
    {
      "kind": "pylon",
      "cost": 14
    },
    {
      "kind": "pylon",
      "cost": 14
    },
    {
      "kind": "pylon",
      "cost": 14
    },
    {
      "kind": "barricade",
      "cost": 4
    },
    {
      "kind": "barricade",
      "cost": 4
    },
    {
      "kind": "turret",
      "cost": 10
    },
    {
      "kind": "barricade",
      "cost": 4
    },
    {
      "kind": "turret",
      "cost": 10
    }
  ],
  "gate": {
    "need": 3
  },
  "tiles": [
    "################################################################################################",
    "#.....................~~~,,,,,,T,,,,,,,,,,,,,,,................_____~~~_________________.......#",
    "#......................~~~,,,,,,,T,,,,,,T,,,,,,................_____~~~_________________.......#",
    "#......................~~~,,,,,,,T,,,,T,T,,,,,,................____~~~__________________.......#",
    "#..............g........~~~,,,#T#,,,,T#TT,,,,,,................____~~~__________________.......#",
    "#.......................~~~,,,,,T#T,,T#T,T,,,,,................____~~~__________________.......#",
    "#.......................~~~,,,,,,,T,,,T,T,,,,,,................n__~~~_n______n______n___.......#",
    "#.......................~~~,,T,,,,,,,,,#,,,,,,,................___________c_____________.......#",
    "#...............c.......~~~,TT,,,,,,,,,,,r,,,,,.............###_######_######_######_####......#",
    "#.......................~,,,TTT,,,,,,,,,,,,,,,,................_________________________.......#",
    "#...........Y...........~,,,,,,,,,,,,,,,c,,,,,,................_________________________.......#",
    "#........................,,,,,,,,,,,,,,,,,,,,,,................_________________________.......#",
    "#........................a,,,,,,,,g,,,,,,,g,,,,...............Y___~~~___________________.......#",
    "#......................B.Bo,,TTT,,,,,,T,,,,,,,,................___~~~___________________.......#",
    "#.............##.........,T,T,TTT,,,,T,T,,,,,,,................____~~~__________###_____.......#",
    "#............###.........a,,T,TT,,,,TTT#TrTT,,,................____~~~__________#_#_____.......#",
    "#.........#...#......~~~.,,,,T,,T,,,T,T,TT,,,,,................____~~~_________####_____.......#",
    "#............##......~~~.,,,,,TT,,,,,TT,,,,,,,,................_____~~~_______##__#_____.......#",
    "#..........#.g#......~~~.,,,,,Y,r,,,,,,,#T,,,,,................_____~~~______r_###______.......#",
    "#...................~~~..,,,,,,,,,,,,,,,,T,,,,,................_____~~~________#_____rr_.......#",
    "#...................~~~..,,,,,,,,,,,,,,,,,,,,,,................______~~~________Y_____c_.......#",
    "#...................~~~..,,,,,,,,,,,,,,,,,,,,,,................______~~~________________.......#",
    "#...................~~~..,,,,,,,,,,,,,,,,,,,,,,################______~~~________________.......#",
    "#.............g.....~~~..,,,,,,,T,,,,,,,,,,,,,,#;;;;;;;;;;;;;;#_______~~~_______________.......#",
    "#................a..~~~..,,,,,,,TT,,,,,,,,,,,,,#;;;;;;s;;;;;;;#_______~~~_______________.......#",
    "#....................~~~.,,,,,,T#,Tr,,,,,,,,,,,#;;;;;;;;;;;;;;#_______~~~__________g___;;;;;;;;#",
    "#....................~~~.,,,,,TTTT,,,,,,,,,,,,,#;;a;;;;;;;;;;;#_______~~~______________;;;;;;;;#",
    "#....................~~~.,,,,,,,,,,,T,,,,,,,,,,#;;;;#######;;;#_______~~~______________;;;;;;;;#",
    "#.....................~~~,,,,,,T,T,,TT,,,,,,,,,#;;;;#;;;;;#;;;#_______~~~___________o_B;;;;a;;;#",
    "#.....................~~~,,,,,,,,,,,,#T,,,,,,o,#;;;;#;N*;;#;;;#_o_____~~~___________##_;;;;;;;;#",
    "#..P.P.................~~~,,,,,,,,,,,,,,TT,,,,,#;;B;#;;m;;#;;;#_______~~~__________#o__;;;s;;;;#",
    "#......N*..............~~,,,,,,,,,,,N*m,,,,,,,B.;s;;#;c;;;#;;;.B_____~~~____________###m;;;;;EE#",
    "#......................~~,,,,,,,,,,,,,,,,,,,,,,.;;;;;;;b;;;;s;.______~~~_____________##;;;;;;EE#",
    "#..P.P..................~,,,,,,,TT,,T#T,,,,,,,,#;;B;#;;;;;#;;;#______~~~________#____#_;;;;;;;;#",
    "#.......................~~~,,,,,T,TT,,,,,,,,,o,#;;;;#;;m;;#;;;#_o______________###g_o__;;;s;;;;#",
    "#.......................~~~,,,,,,,,,T,,,,,,,,,,#;;;;#;;;;;#;;;#___________#__#_#_#_____;;;;;;;;#",
    "#.......................~~~,,,,,,,,,,,,,,,,,,,,#;;;;#;;;;;#;;;#__________###_##_____o__;;;;a;;;#",
    "#................#......~~~,,,,,,,,,,,,,,,,,,,,#;;;;#######;;;#__________###_##_____Y__;;;;;;;;#",
    "#...............#.......~~~,,,,,,,,,,,,,,,,,,,,#;;;;;;;;;;;a;;#___________r###_______g_;;;;;;;;#",
    "#...............##.....~~~,,,,,,,,,,,,,T,,,,,,,#;;;;;;;;;;;;;;#____~~~______g#r________;;;;;;;;#",
    "#....##..#.....###.....~~~,,,,,,,,,,,,,,T##,,,,#;;Y;;;s;;;;;;;#____~~~_____###__________.......#",
    "#......##..............~~~,,,,,,,,,,,,T#,T,,,,,#;;;;;;;;;;;;;;#___~~~_____###___________.......#",
    "#.......g##...a.......~~~,,,g,T,T,,,,,,,T,,,,,,#######..#######___~~~____#_##___________.......#",
    "#.....####............~~~,,,,,,T#,,,,,,TT,T,,,,................___~~~_______#___####____.......#",
    "#........................,,,,,,,T,,,,,,,,,Y,,,,.....o....o.....___~~~___________###_____.......#",
    "#........................a,,,,,,TT,,,T,T,T,,,,,................___~~~__________##_______.......#",
    "#......................B.,,,,,,,,,,,,,,#,,#,,,,...........::::::::~~~::::::::::::::::::_.......#",
    "#........................,o,T##,,,,,,,T,,#,,,,,...........:::::~~~~~~:w::::::w:::::::::_.......#",
    "#........................a,,T#T,g,,,,,,T,T,,,,,...........:::::~:~~~~w::~~::::g::::::::_.......#",
    "#...........g.......~~~..,,,TTTTT,,,,,g,,,,,,,,...........::::~::~:~~~~w~:~::::::::::::_.......#",
    "#...................~~~..,,,,,TT#T,,,,,,,,,,,,,...........::::::~*~~~~~B::~~::Y::::::::_.......#",
    "#.................a.~~~..,,,,,,,T,,,,,,,,,,,,,,...........::::::~N~~~~~w:~:::~:::::::::_.......#",
    "#.........#....Y....~~~..,,,,,,,,,,,,,,,,,,,,,,...........::::::~:~~~~~:::::~::::::::::_.......#",
    "#..............g....~~~..,,,,T,,,,,,,,,,c,,,,,,...........::::::::~~~~~:c:::~~:~::~~:::_.......#",
    "#..........#.........~~~.,,,,TT,,,,,,,,,,,,,,,,...........:~~~::::::~~~:::::~~:n~~:~~::_.......#",
    "#..........###..c#...~~~.,,,,#T,,,,,,,,,,,,,,,,...........~~~~::::Y:::::::::~:~~~:~~~::_.......#",
    "#.........##.#....#.#.~~~,,,,,#,,,,,g,,,r,,,,,,...........::~::::::::::~::~~~~~~~~~~:::_.......#",
    "#..........###...###..~~~,,#T,,,,,,,TT,,,,,,,,,...........::~~::::w:~~~~::::w~~~::~~~~:_.......#",
    "#.........#...#..##.#.~~~,T,TT,,,g,T,T,,T#,,,,,...........::~~:::::~~~~~~:::~~~~w:~::::_.......#",
    "#.................#....~~~T,,,,,,,,,T,T,#,T,,,,...........:::::::::~:~~~~:~~~::::::::::_.......#",
    "#......................~~~T,T,,,,,,#TT,,,T,,,,,...........:::::::::::~~~~::~:~~~:::::::_.......#",
    "#.......................~~T,T,,,,,T##TT,,,,,,,,................_______~~~_____~_________.......#",
    "#.......................~~~,,,,,,,,,,,,,,,,,,,,................_______~~~_______________.......#",
    "################################################################################################"
  ]
}
