{
  "name": "Broken Quorum",
  "objective": "Cross the dead relay field and raise four pylons — make the count true again",
  "time": 720,
  "story": true,
  "chapter": 3,
  "title": "Chapter III — Broken Quorum",
  "expedition": true,
  "intro": [
    {
      "title": "Chapter III — Broken Quorum",
      "lines": [
        "The relay field answered six of ten. Six is not a quorum.",
        "Ash where the pylons stood. Phantoms where the keepers slept.",
        "Raise four. Make the count true again."
      ],
      "art": "quorum"
    }
  ],
  "outro": [
    {
      "title": "Four of Four",
      "lines": [
        "The quorum holds. The relay field hums for the first time since the Fall.",
        "Keeper Vasht counts to ten now. All the way to ten. And smiles."
      ],
      "art": "quorum"
    }
  ],
  "captiveChars": [
    "shade",
    "warden"
  ],
  "npcs": [
    {
      "id": "keeper-vasht",
      "name": "Keeper Vasht",
      "lines": [
        "Six of ten... six of ten. The field answered six and the quorum wanted seven.",
        "I logged the fault at dusk. By dawn the Entropy had eaten four pylons whole.",
        "I kept the count. I always keep the count. Counting is all the keeping I have left.",
        "The Phantoms nest behind the ridge — they see farther than you do. Break their line with a barricade or feed it.",
        "Four fresh pylons, operator. All four. This Anchor takes no fractions.",
        "Take my shards. They were for repairs that never... just take them."
      ],
      "gift": {
        "shards": 8
      }
    },
    {
      "id": "junie-marrow",
      "name": "Junie 'Hope' Marrow",
      "lines": [
        "Hope! Genuine bottled hope, friend — three shards a measure and worth every one.",
        "Sold out of medicine two seasons back. Hope keeps better. Never expires, rarely works.",
        "Free sample: crystal nodes along the road crack open at four shards apiece. Shoot them.",
        "The chargers in the open ash don't want hope. They want you. Keep a sandbag between you.",
        "When the gate lights, I ride through first. That's not hope, friend — that's a plan."
      ]
    }
  ],
  "builds": [
    {
      "kind": "barricade",
      "cost": 4
    },
    {
      "kind": "pylon",
      "cost": 12
    },
    {
      "kind": "pylon",
      "cost": 12
    },
    {
      "kind": "turret",
      "cost": 10
    },
    {
      "kind": "pylon",
      "cost": 12
    },
    {
      "kind": "pylon",
      "cost": 12
    },
    {
      "kind": "barricade",
      "cost": 4
    },
    {
      "kind": "turret",
      "cost": 10
    }
  ],
  "gate": {
    "need": 4
  },
  "tiles": [
    "################################################################################################",
    "#______________________________________________##______________________________________________#",
    "#_______________________________________________##_____________________________________________#",
    "#_______________________________________________##_____________________________________________#",
    "#_______________________________#________________##____________________________________________#",
    "#_________________________##___###_______________##______#______#____#_________________________#",
    "#_________________________##____#________#_______##___c_###____________________________________#",
    "#___________##_____##_____:::____________________##______#___________________#_________________#",
    "#___________##_____##____:_:::;;_______________________________________________________________#",
    "#________________________:::::;;___________________n___________________________________________#",
    "#________________________:::::;;_______________________________________________________________#",
    "#__________________________::_;;_________________________:::___________________________________#",
    "#_____________________________;Y________________#_______:::::_n________________________________#",
    "#________________________T#___;;__##____#______##_______:::r:__________________________________#",
    "#___________#_______##________;;__##___________##______T::::__________#________________________#",
    "#__________###______##________;;______________##_________##:___#____________#__________________#",
    "#___________#___T__g__________;;______________##_________##____________________________________#",
    "#_____________________________;;______________#________________________________________________#",
    "#_____________________________;;_____________##________________________________________________#",
    "#_______________a_____________;;__a__________#______________________________n__________________#",
    "#_____________________________;;_______________________________________________________________#",
    "#_________________________##__;;____________B_____Yn____#____________#________#___;;;o;;;;;;;;;#",
    "#____________g__Y_________##__;;_#_____________________###____##____###___________;;;;Y;;;;;;;;#",
    "#__________##_____#___________;;###______#___##_________#_____##_____#____________;;c;;;;;;;;;;#",
    "#__________##_________________;;_#____________##________________r________________o;;;;;;;;;;;;;#",
    "#___________________N*________;;_____g________##__________________________________;;;;;;;;;;;;;#",
    "#__P_P________B_____________;;;;;;Y;g;;;;;;;;;____________a_B_________Y__r_a;;;;;;;;;;;;;;;;;;;#",
    "#_;;_________________r;;;;;a;;;;;;;;;;;;;;;;;;;;;;;;__________________;;;;;;;;;;;;;;B;;;;;;;;EE#",
    "#_;;;;;;;Y;;;;;;;;;;;;;;;;g;__________________;;;;;;;;;;;;;;;;;;;;;;;;;;;;;;______;;;;;B;;;;;EE#",
    "#__P;P;;;;;;;;;;;;;;;__________g________________##__;;;;;;;;;;;;;;;;;;____________;;;;;;;;;;;;;#",
    "#______________________rY_____________B_________##______N*______;;____________Y___;;;;;;;;;;;;;#",
    "#_______________________________________________________________;;__a____________o;;;;;;;b;;;;;#",
    "#________________________________________________________Y______;;________________;;;;;;;;;;;;;#",
    "#___________________________r_______________B______n____________;;________________;;;;;;;;;;;;;#",
    "#_________________________________________Y_________B___________;a_____________n__;;;;;;;;;;;;;#",
    "#_____________________a__________r_______________##_____________;;________________;;;o;;;;;;;;;#",
    "#______________________________________r_#_______##_____________;;_____________________________#",
    "#____________#____#______#______________###______#____________r#;;_________a___________________#",
    "#___________###__###_____g_______#_______#______#_______#______#;;____#___::##_________________#",
    "#____________#____#_____________________________##_____###______;;______::_:##_________________#",
    "#___________::_________________________________##_______#_______;;__n___:::::__________________#",
    "#__________:_:__________________________________________________;;______:_:____________________#",
    "#_________:T:::____________________:::_________##_____T_________;;_______:_:___________________#",
    "#_________:::::___________________:::::_______##_____T__________;;_____________________________#",
    "#__________::_____________________::_::#______________T_________;;___T_________________________#",
    "#____________#_____#_______#____##::::###__________n____________;;___m_______##________________#",
    "#___________###___###___________##_::__#_________________##___#_;Y____##_____##________________#",
    "#____________#_____#_________________________##______T___##_____;;____##_______________________#",
    "#___________________________ga_______________#__________________;;_____________________________#",
    "#_________________T__________________________##________________________________________________#",
    "#____________________________________________#_________________________________________________#",
    "#_____________________________________________##_______________________________________________#",
    "#_____________________________________________#________________________________________________#",
    "#_____________________________________________#________________________________________________#",
    "#______________________________________________##______________________________________________#",
    "################################################################################################"
  ]
}
