{
  "name": "The Last Bastion",
  "objective": "Hold the bastion through five nights — the core must still stand at the fifth dawn",
  "time": 600,
  "expedition": true,
  "mode": "bastion",
  "bastion": {
    "nights": 5,
    "dayLen": 90,
    "nightLen": 75,
    "bloodMoons": [
      3,
      5
    ]
  },
  "intro": [
    {
      "title": "The Last Bastion",
      "lines": [
        "One bastion still answers on the frontier band: five nights from relief.",
        "Every dusk the Entropy marches a lane. Two moons will rise blood.",
        "Wall the gaps. Crew the towers. The core must not fall."
      ],
      "art": "siege"
    }
  ],
  "outro": [
    {
      "title": "The Fifth Dawn",
      "lines": [
        "The fifth dawn breaks over chewed walls and a core still humming.",
        "Relief columns crest the lanes the waves came down.",
        "The frontier holds — because this one did."
      ],
      "art": "dawn"
    }
  ],
  "captiveChars": [],
  "builds": [
    {
      "kind": "barricade",
      "cost": 4
    },
    {
      "kind": "barricade",
      "cost": 4
    },
    {
      "kind": "turret",
      "cost": 10
    },
    {
      "kind": "turret",
      "cost": 10
    },
    {
      "kind": "barricade",
      "cost": 4
    },
    {
      "kind": "turret",
      "cost": 10
    },
    {
      "kind": "barricade",
      "cost": 4
    },
    {
      "kind": "farm",
      "cost": 6
    },
    {
      "kind": "farm",
      "cost": 6
    },
    {
      "kind": "turret",
      "cost": 10
    },
    {
      "kind": "farm",
      "cost": 6
    },
    {
      "kind": "farm",
      "cost": 6
    },
    {
      "kind": "barricade",
      "cost": 4
    },
    {
      "kind": "barricade",
      "cost": 4
    }
  ],
  "chests": [
    {
      "loot": "medkit",
      "amount": 1
    },
    {
      "loot": "shards",
      "amount": 8
    },
    {
      "loot": "cracker",
      "amount": 2
    },
    {
      "loot": "token",
      "amount": 1
    },
    {
      "loot": "token",
      "amount": 1
    },
    {
      "loot": "shards",
      "amount": 12
    },
    {
      "loot": "shield",
      "amount": 1
    },
    {
      "loot": "controller",
      "amount": 1
    },
    {
      "loot": "shield",
      "amount": 1
    },
    {
      "loot": "shield",
      "amount": 1
    },
    {
      "loot": "toxin",
      "amount": 1
    },
    {
      "loot": "shards",
      "amount": 7
    },
    {
      "loot": "shards",
      "amount": 9
    },
    {
      "loot": "medkit",
      "amount": 1
    },
    {
      "loot": "cracker",
      "amount": 2
    }
  ],
  "vehicles": [
    {
      "kind": "skiff"
    },
    {
      "kind": "stag"
    },
    {
      "kind": "stag"
    }
  ],
  "hires": [
    {
      "job": "hound",
      "cost": 10,
      "name": "Fang Berro"
    },
    {
      "job": "farmer",
      "cost": 8,
      "name": "Sage Imbra"
    },
    {
      "job": "engineer",
      "cost": 10,
      "name": "Wrench Odal"
    },
    {
      "job": "smith",
      "cost": 12,
      "name": "Forgemaster Hesk"
    },
    {
      "job": "archer",
      "cost": 12,
      "name": "Fletch Roan"
    }
  ],
  "tiles": [
    "####################################################################################",
    "#,,.,,,,,,,,,.,..,,,...,..,,,,,,...................................................#",
    "#,.,,,,,,,,,,.,,,,TTT,,TT,..T,.,..................#.#..............................#",
    "#.,,,..,,,,.,,,,,T,TT,TT.TT,,..,..................###C......a......................#",
    "#.,,,,,,T,..,,,,,,TTTT,,T,T,,,T............#....#.####.........:::::::.............#",
    "#,,,,TTTC,,,,,,.,,,T,TTTTT,.TT.,...........##....##..#.......::~~~~~~~::...........#",
    "#,,..TTTTT,,,,,,.,T,,C,,T,T,TT,.............#...........g...:~~~~~~~~~~~:..........#",
    "#,.,,TTT,T,,.,,,,,,..,.,TT,T.,,............##..............:~~~~~~~~~~~~~:.....C...#",
    "#,,.,T,TTTT,.,,.,,,,TT,..gT,TT,,........#..#.#...........#:~~~~~~~~~~~~~~~:........#",
    "#.,.,,,,TT,T,,,.,,TT,,T,,.,.,T,,.............#...........#:~~~~~~~~~~~~~~~:...###..#",
    "#.,TT,TT,,g..,,,,TTTw,,,,.,.,,,,...........Y.............#~~~~~~~:::~~~~~~~:....##.#",
    "#.,TTT,,,,,,,,.,TTTTTT,T,,,,,,,,...........#.............#~~~~~~:C,C:~~~~~~:.#n##..#",
    "#.,,,T,,,,,.,,,.T,,TTT,,a.,,,,.,...........#.............:~~~~~~:,,,:~~~~~~:..####.#",
    "#,.,,,,.,.,,,,,,,,.T,,,,,,,...,............#.............:~~~~~~:,C,:~~~~~~:.#.##..#",
    "#.,,,,,,,,,,,.,,,,gTTT.,,.,,C,,,.........................:~~~~~~~:::~~~~~~~#.#.....#",
    "#.,,,,,,,,..,,,Y,.T,T,,.,,,,,,,,..........................#~~~~~~~~~~~~~~~#.#......#",
    "#,,,,.,TT,.,w,,,,,,,T.,,,,,,,,,..........Y................V~~~~~~~~~~~~~~~#.a......#",
    "#,,,T,,TT.,,.,,,...TT,,,.,,.,.,,...........................:~~~~~~~~~~~~~###.......#",
    "#,,.TTTTT,,.,,,.TT,,,,,,,,,.,,.,............................:~~~~~~~~~~~#...#......#",
    "#,,.,T,TT.,.,,,.T,TTT,,,,,,,,,,,.............................::~~~~~~~::...#.......#",
    "#,,TTT,.T..,,,g.,,.T,,,,,.,,,,.,...............................:::::::.............#",
    "#,T,TTT,.T,.,.,,,TTT,,,..,,,,,,,...................................................#",
    "#,T.T,TTT,,,,,,.,,,,,,,.,,,,,,,,.......o....o.........................g............#",
    "#..,TTT,,,,.,,,,,.,,,,,.,.,,,,,,...................................................#",
    "#....T.T........#...............#########BB##########..............................#",
    "#................#..............#;;;;;;;;;;;;;;;;;;;#..............................#",
    "#.............#.##..............#;W;;;;;;;;;;;;;;;W;#..............................#",
    "#...............#...............#;;;;;;;;;;;;;;;;;;;#..............................#",
    "#...............................#;;;;;B;;;;;;;S;;;;;#..............................#",
    "#...............................#;;H;;;;;;*;;;;;;;;;#..............................#",
    "#....C........................o.#;;;;;;;P;;;P;;;;;;;#.o..#.........................#",
    "#...........Y...................#;;H;;B;;;;;;V;;;;;;#.......Y.................Y....#",
    "#...............................B;;;;;;;;;K;;;;;;;B;B..............................#",
    "#...................Y...........#;;H;;;;;;;;;V;;;;;;#..#..............Y.....C.#....#",
    "#.............................o.#;;;;;;;P;;;P;;;;;;;#.o..#....................##...#",
    "#...............................#;;H;;;;;;*;B;B;;;;;#..##.................#.###.#..#",
    "#...............................#;;;;;B;;;;;;;;;;;;;#.....................##.#.....#",
    "#...............................#;;H;;;;;;;;B;B;;;;;#.......................##.#...#",
    "#.......r.......................#;W;;;;;;;;;;;;;;;W;#.......................#......#",
    "#...............................#;;;;;;;;;;;;;;;;;;;#..............................#",
    "#........................##.....#########BB##########...........#..................#",
    "#:::.::.::::::::..::::::.##::..:.....................____.__C._.__##._._____.__.__.#",
    "#.::::.::::::::::::.:.:.::##::::.......o....o........_________.#.###__.______..___.#",
    "#::..:.:::::::::..::::.:..::::::....................._________.__#_#._##__.________#",
    "#:.:..::::g::..::::..::.:::::.::.....................___.___.__..#_#####._s._._____#",
    "#::.::::.:~~~:::::.:.::::::::.::......................#__.#.._._.#_#_####_.____..__#",
    "#.:::.:.:~~:~:::.::.##.:::..:::.......................__#.#.__.._.g__Y.__.___.a___.#",
    "#:.:::::~:~:::::::::#:::.:::.:.:.......##............____##__.______.#_#.__.._.____#",
    "#::::.:::::.::::.:::..:.:::.:.###.......#Y.....#......###__.._________#._._#_______#",
    "#:::::.::::.:..::~::..:.:::.:#:##.......#......#......____#Y______##.______._._____#",
    "#:..:..::::..:w:~~:::.:::::..###......................._#._.####_#._______#._._____#",
    "#:::::..:.:::..#~:::::..:.::::::.....................____.#.##_##___##_____###.___.#",
    "#::.:.::C:::.##::.:.:.:.:.::::.......................__.._a####._###__r_._##__C____#",
    "#.:.::::.::::#:#####r.:..:::.:.:....................._.___##.##.##_#_#_.__#_.__.._.#",
    "#.:.:.::::::::::#:#:::~::::.::::..........Y#..........____r###_###__.______#_..____#",
    "#...::.::.:..:#::::.:~~~:::::.:............#..#......_____._######s#_________..__._#",
    "#:.::::~::.::::#g:#.:~~~~:..::::...........###......._._____######..#...___.____.._#",
    "#:.:.:a~~::::.::...::::~::C:::::........#..##.........___C.____#_.##_____._..___n._#",
    "#:::.:~~~::::::::.:.::::::::::..............##.......___.____.#_#_#______.__g______#",
    "#:.::::~:.::::..:::::::...:..:.:........#....#.......___...._#_______._____._______#",
    "#:.::.:::..:::::.::...:.w:.:::.............#.........__.___._______.__._###._______#",
    "#:.:::::.::.:.::.::::::::::::::......................_.__..__.___._____._###.___._.#",
    "#:::::::::..::..::::::::.:::..::.....................__.__..___________.____.____._#",
    "####################################################################################"
  ]
}
