{
  "name": "Lythium Basin",
  "story": true,
  "chapter": 2,
  "title": "Chapter II — Lythium Basin",
  "expedition": true,
  "objective": "Descend the drowned refinery basin — raise two relay pylons to wake the southern Anchor",
  "time": 660,
  "intro": [
    {
      "title": "The Drowned Works",
      "lines": [
        "The flood took the refinery in one night. The LYTH stayed.",
        "Leeches wallow in the channels, glowing with stolen shards.",
        "Two relays wake the basin Anchor. Keep the signal alive."
      ],
      "art": "basin"
    }
  ],
  "outro": [
    {
      "title": "The Basin Settles",
      "lines": [
        "The second Anchor hums under the waterline. Finality spreads.",
        "The foreman stands a long while, watching the channels run clean.",
        "East, past the ash fields, the broken quorum waits."
      ],
      "art": "basin"
    }
  ],
  "captiveChars": [
    "engineer",
    "volt",
    "seal"
  ],
  "npcs": [
    {
      "id": "saba-marrow",
      "name": "Saba Marrow, Leech-Hunter",
      "lines": [
        "Hsst. Keep low. See them wallowing in the channels? Leeches — fat on stolen LYTH.",
        "They glow gold where they have fed. Kill one and the shards spill right back out.",
        "Slow brutes, but they soak hits like mud soaks rain. Back up, keep firing, get rich.",
        "Skitters run the water margins in packs. Never take them standing in a channel mouth.",
        "Fifteen crystal seams in this basin by my count. Crack every one. The basin owes you."
      ]
    },
    {
      "id": "foreman-vael",
      "name": "Foreman Eshe Vael",
      "lines": [
        "Lythium Basin works. Three hundred hands on shift when the levee gave. One night. All of it under.",
        "The refinery floors still stand proud of the flood. Fight from the stone — the mud belongs to them now.",
        "Two pylons wake this Anchor. One here on my floor, one down at the southern gate. A quorum of two.",
        "Take these. The last seam we ever cut. Build something that outlasts the water.",
        "My crews stacked those sandbags when it rose. Still holding the line. So am I."
      ],
      "gift": {
        "shards": 6
      }
    }
  ],
  "builds": [
    {
      "kind": "barricade",
      "cost": 4
    },
    {
      "kind": "pylon",
      "cost": 14
    },
    {
      "kind": "turret",
      "cost": 10
    },
    {
      "kind": "barricade",
      "cost": 4
    },
    {
      "kind": "barricade",
      "cost": 4
    },
    {
      "kind": "pylon",
      "cost": 14
    }
  ],
  "gate": {
    "need": 2
  },
  "tiles": [
    "########################################################################################",
    "#......................................................................................#",
    "#........................................P..P..........................................#",
    "#...............T.#..............#......................T.......................T......#",
    "#.....T..........................##......P..P..........................#.#.............#",
    "#...................g.#......##..#....Y...........................g...T.##.............#",
    "#......................#....T..##.#....N*..............................................#",
    "#......................#..........................Y....................................#",
    "#:::~~~~~~~~~~~~::::::::::::::::::~~~~~~~~~:::::::::::::::::::::~~~:::~~~~~~:::::::::::#",
    "#~~~~~~~~~~~~~~~~~~:::::::w::::~~~~~~~~~~~~:B:~~~:.::::::::::~~~~~~:::~~~~~~~~~::::::::#",
    "#~~~~~~~~~~~~~~~~~~:::~~~~~~~~~~~~~~~~~~~~~:::~~~~~~~~~~~~~~~~~~~~~:::~~~~~~~~~~~~~~~~~#",
    "#~~~:~:~w:~~::::~~~:::~~~~~~~~~~~~:::::~::::::~~~~~~~~~~~~~~~~~~::::::::::w:~~~~~~~~~~~#",
    "#:::::~~::~~::::::::::~~~~~~~~~g~~:::~:~~:::::.::~~~~~~~~~~~~:::::::::~~~:::::~~~~~~~~~#",
    "#::::~~:~:~~::Ys::::::::::::::::~~:::::~::::::::::::::::~~g:::::::::::~~::::::~~:::::::#",
    "#::::::~~:~~::::::::::::::::::::~~:::::~:::::::::::::~~~~~::::::::::::::~:::::~~::T::::#",
    "#:::::::::~~::::::::::::::::::::~~::::::::::Y:::::~~:::~~~::::::::::::::::::::~~:::::::#",
    "#:::::::::~~::::::::::::r:~~::::~~:::::::::s:::::w~~::::~~::r::::::::s::~~::::~~:::::::#",
    "#:::::T:::~~:::::::::::::w~~~T::::::::::::::::::::~~::::~~::::::::::::Y:~~:::::::::::::#",
    "#:::::::::::::::::g::::::Y~~:~~~:::::::~~:::::::::~~::::::::::::::::::::~~:::::::::::::#",
    "#::::::::::::::::w::::::::~~~::~~::::::~~w::::::::~~::::::T:::::::::::g:~~:::::::::::::#",
    "#::::::~~~~:::~~~~~:::::::~~:::~:~::::~~~~~~~~~~::~~::::::::::::::w~~~~~~~~~~~:::::::::#",
    "#:::~~~~~~~:::~~~~~~~~::::~~~:::~:~:::~~~~~~~~~~~~~~:::::::::::~~~~~~~~~~~~~~~~::::::::#",
    "#~~~~~~~~~~:::~~~~~~~~~~~~~~~~~~~~~:::~~~~~~~~~~~~~~~~~~~~~:::~~~~~~~~~~~~~~~~~:::~~~~~#",
    "#~~~~~~::::::::::::~~~~~~~~~~~~~~~~:::::::::::::~~~~~~~~~~~:::~~~~~:::::::::::~:::~~~~~#",
    "#~~~::::::::::::::::::~~~~~~~~~~~~###;######;;###########~~:::~:::::::::::::::::::~~~~~#",
    "#:::::::;;;;;;;;;;;;;;;;;;;:::::::#;;;;;;;;;;;;;;;;;;;;;#:::::;;;;;;;;;;;;;;;;;;;::::::#",
    "#:::::::;;o;##;;;;;;;;;;o;;:::::::#;;;a;;;o;;;;o;;a;Y;;;#:::::;;o;;;;;;;;;;;##o;;::::::#",
    "#:::::::;;;;Y;;;;;;;;;;;;;;:::::::#;;;;;;;;;;;;;;;;;;;;;#:::::;;;;;;;;;;;;;;;;;;;::::::#",
    "#:::::::;;;;as;;;;;;;;;;;;;:::::::#;;;####;;;;;;c;;;;;;;#:::::;;;;a;;;n;;s;;;;;;;::::::#",
    "#:::::::;;;;;;m;;;;;;;;;;;;:::::::#;;;;;;;;;;;;;;;;;;;;;#:::::;;;;;;;;;;;;Y;;;;;;::::::#",
    "#:::::::;;;;;;;;;;;;a;;;;;;:::::::;;;;;;N*;;B;;;;;;;;;;;;:::::;;;;;;;;;;;;a;;;;;;::::::#",
    "#:::::::;;;;;;;;;;;;;;##;;;:::::::;;;;;;;;;;;;;;;;;;;;;;;:::::;;;;##;;;;;;;;;;;;;::::::#",
    "#:::::::;;o;;;;;;;;;;;;;o;;:::::::#;;;;;;;;;;n;;;;;;;;;;#:::::;;o;;;;;;;;;;;;;o;;::::::#",
    "#:::::::;;;;;;;;;;;;;;;;;;;:::::::#;;;;;;;;;;;;;####;;;;#:::::;;;;;;;;;;;;;;;;;;;::::::#",
    "#:::::::::::::::::::::::::::::::::#;;;a;;;;;;;;;;;;;a;;;#::::::::::::::::::::::::::::::#",
    "#:::::::::::::::::::::::::::::::::#;;;;;;;o;;B;o;;;;;;;;#::::::::::::::::::::::::::::::#",
    "#:::::::::::::::::::::::::::::::::#;;;;;;;;;;;;;;;;;;;;;#::::::::::::::::::::::::::::::#",
    "#:::::::::::::::::::::::::::::::::##########;;######;####::::::::::::::::::::::::::::::#",
    "#::::::::::~~~~~~~~~~~~::::::::::::::::::~~~~~~:::~~~:::::::::::::::::::::~~~~~~~~:::::#",
    "#:::::::~~~~~~~~~~~~~~~:::::::::::::::~~~~~~~~~:B:~~~~~~:::::::::::~~~~:::~~~~~~~~~~~~:#",
    "#~~~~~~~~~~~~~~~~~~~~~~:::~~~~~~~~~~~~~~~~~~~~~:::~~~~~~~~~~~~~~~~~~~~~:::~~~~~~~~~~~~~#",
    "#~~~~~~~~~~:::::::::w:::::~~~~~~~~~~~~~~~:::w::::::::~~~~~~~~~~~~~~~~~~:::::::::::~~~~~#",
    "#~~~~~~~::::~~::::::::::::~~~~~~~~~~~~~~::::::r::::::::~~~~~~~~~~~~w::::::::::::::::::~#",
    "#:::::::::::~~::::::::~:::::::::::::::~~::::::::::::::~~~:s~::~~::~~:::::::::::::::::::#",
    "#:::::::::Ys~~::::::::~:::::::g::~::::~~::::::::::::::::::Y~~:~~::::::::g:::~~s::::::::#",
    "#:::::::::::~~:::::::::~::::~~~~~~:sr:~~:::::::~~:::::::::::~~~~::::::::::::~~:::::::::#",
    "#:::::::::::~~::::::c:::~:::~~~::~Y:::~~::::::::~:::~~:::::~::~~m:r:::::::::~~Y~~::::::#",
    "#:::::::::::~~g:::::::::~:::~~:~::::::::::::::::::::~~g:::::~~~~:~::::::::::~~~~w:T::::#",
    "#:::::::::::w::::::::::~~~::~~::::::w:::::::::::::::~~::::::w:~~::::::c:::::~~~:~::::::#",
    "#:::::::::::::::::~~~~~~~~~~~~::~:::::::::::::::~~~~~~~~~~~~::::::::::::::::~~~~~~~~~~~#",
    "#~~:::::::::::::::~~~~~~~~~~~~~~~:::::::::::B:~~~~~~~~~~~~~~~~~::::::::::::~~~~~~~~~~~~#",
    "#~~~~~~~~~~~~~~:::~~~~~~~~~~~~~~~~~~~~~~~~~:::~~~~~~~~~~~~~~~~~~~~~~~:::~~~~~~~~~~~~~~~#",
    "#~~~~~~~~~~~~~~:::::::::::::::~~~~~~~~;;;;;;;;;;;;;;;:::::::~~~~~~~~~:::~~~~~~:::::::::#",
    "#::~~~~~~~~~~~~::::::::::::::::::~~~~~;;;;;;B;;;;;;;;::::::::::~~~~~~:T:~~~::::::::::::#",
    "#:::::::T:::::::::::::::::::::Y:::::::;;;;;;;;;;;;;;;:::::Y::::::::::::::::::::::::::::#",
    "#:::::::::::::::::::::::::::::::::::::;;a;;;;;;;n;;;;::::::::::::::::::::::::::::::::::#",
    "#:::::::::::::::::::::::::::::::::::::;;;;;;EE;;;;;;;::::::::::::::::::::::::::::::::::#",
    "#:::::::::::::::::::::::::::::::::::::;;;;;;EE;;;;;;;::::::::::::::::::::::::::::::::::#",
    "#:::::::::::::::::::::::::::::::::::::;;;;;;;;;;;;;;;::::::::::::::::::::::::::::::::::#",
    "########################################################################################"
  ]
}
