{
  "name": "The Long Crossing",
  "objective": "Cross the frontier west to east — rescue the stranded, reach the far gate",
  "time": 720,
  "expedition": true,
  "captiveChars": [
    "volt",
    "raider",
    "sniper",
    "atlas",
    "bastion",
    "duelist",
    "shade",
    "pyro"
  ],
  "tiles": [
    "################################################################################################",
    "#.....................~~~......#....................................~~~........................#",
    "#......................~~~.......#......#...........................~~~........................#",
    "#......................~~~.......#....#.#..........................~~~.........................#",
    "#..............g........~~~...###....####..........................~~~.........................#",
    "#.......................~~~.....###..###.#.........................~~~.........................#",
    "#.......................~~~.......#...#.#g.....................n..~~~.n......n......n..........#",
    "#.......................~~~..#......r..#..................................c....................#",
    "#...............c.......~~~.##..............................###.######.######.######.####......#",
    "#.......................~...###................................................................#",
    "#.......................~...............c......................................................#",
    "#..............................................................................................#",
    "#........................a........g.......g.......................~~~..........................#",
    "#.........................o..###......#...........................~~~..........................#",
    "#.............##..........#.#.###....#.#g..........................~~~..........###............#",
    "#............###.........a..#.##....#####.##.......................~~~..........#.#..g.........#",
    "#.........#...#......~~~.......g#...#.#.##.........................~~~.........####............#",
    "#............##......~~~......##.....##.............................~~~.......##..#............#",
    "#..........#.g#......~~~................##..........................~~~......r.###.............#",
    "#...................~~~..................#..........................~~~........#...............#",
    "#...................~~~.............r................................~~~..............c........#",
    "#...................~~~..............................................~~~.......................#",
    "#...............g...~~~........................################......~~~.......................#",
    "#.............g.....~~~.........#..............#..............#.......~~~......................#",
    "#...................~~~.........##.............#......s.......#.......~~~......................#",
    "#....................~~~.......##.#r...........#..............#.......~~~.....g......g.........#",
    "#....................~~~......####.............#..a...........#.......~~~..........r...........#",
    "#....................~~~............#..........#....#######...#.......~~~...........g..........#",
    "#.....................~~~......#.#..##.........#....#.....#...#.......~~~........g..o......a...#",
    "#.....................~~~............##......o.#....#.....#...#.o.....~~~...........##.........#",
    "#..P.P.................~~~..............##.....#....#..m..#...#.......~~~..........#o.....s....#",
    "#......................~~.............m..........s..#.c...#..........~~~............###m.....EE#",
    "#......................~~..............................b....s........~~~.............##......EE#",
    "#..P.P..................~.......##..###........#....#.....#...#......~~~........#....#.........#",
    "#.......................~~~.....#.##.........o.#....#..m..#...#.o..............###r.o.....s....#",
    "#.......................~~~.........#..........#....#.....#...#...........#..#.#.#.............#",
    "#.......................~~~....................#....#.....#...#..........###.##.....o......a...#",
    "#................#......~~~....................#....#######...#..........###.##..g...r.........#",
    "#...............#.......~~~....................#...........a..#...........g###.................#",
    "#...............##.....~~~.............#.......#..............#....~~~....##.#.................#",
    "#....##..#.....###.....~~~..............###....#......s.......#....~~~.....###.................#",
    "#......##..............~~~............##.#.....#..............#...~~~.....###..................#",
    "#.......g##...........~~~...g.#.#.......#......#######..#######...~~~....#.##..................#",
    "#.....####..g.........~~~......##......##.#.......................~~~.......#...####...........#",
    "#...............................#...................o....o........~~~...........###............#",
    "#........................a......##...#.#.#........................~~~.........r##..............#",
    "#.............a........................#..#.......................~~~..........................#",
    "#.........................o.###.......#..#.....................~~~~~~........w.................#",
    "#........................a..###........#.#.....................~.~~~~w..~~.....................#",
    "#...........g.......~~~.....#####.....g.......................~..~.~~~~.~.~........ww..........#",
    "#...................~~~.......####r.............................~.~~~~~...~~...................#",
    "#.................a.~~~.........#...............................~.~~~~~w.~...~.................#",
    "#.........#.........~~~.........................................~.~~~~~.....~..................#",
    "#..............g....~~~......#..........c.........................~~~~~.c...~~.~..~~...........#",
    "#..........#....a....~~~.....##...........r................~~~......~~~.....~~.n~~.~~..........#",
    "#..........###..c#...~~~.....##...........................~~~~w.....w.......~.~~~.~~~..........#",
    "#.........##.#....#.#.~~~.....#.............................~..........~..~~~~~~~~~~...........#",
    "#..........###...###..~~~..##.......##.g....................~~......~~~~....w~~~..~~~~.........#",
    "#.........#...#..##.#.~~~.#.##...g.#.#..##..................~~.....~~~~~~...~~~~..~............#",
    "#.................#....~~~#.........#.#.#.#........................~.~~~~.~~~..................#",
    "#......................~~~#.#......###...#...........................~~~~..~.~~~...............#",
    "#.......................~~#.#.....#####...............................~~~.....~................#",
    "#.......................~~~...........................................~~~......................#",
    "################################################################################################"
  ]
}
