{
  "name": "Final Settlement",
  "story": true,
  "chapter": 6,
  "title": "Chapter VI — Final Settlement",
  "expedition": true,
  "objective": "Breach the three rings and raise the Settlement Anchor — bring the expedition home",
  "time": 780,
  "captiveChars": [
    "atlas"
  ],
  "npcs": [
    {
      "id": "old-tarn",
      "name": "Old Tarn",
      "lines": [
        "You. Thought the swamp kept you. Then I thought the road did. Glad to be wrong twice.",
        "Take these — saved them since the crossing. The LYTH remembers everyone who ever carried it.",
        "Two pylons this time, one in each outer ring. Both lit, or the settlement gate stays cold.",
        "The rings were raised to keep the Entropy out. Now it mans the walls. Funny old frontier.",
        "Snipers nest along the windbreaks — slip through the tree gaps and they go blind.",
        "Settle it for good, operator. I'm done walking."
      ],
      "gift": {
        "shards": 8
      }
    },
    {
      "id": "quiet-settler",
      "name": "The Quiet Settler",
      "lines": [
        "We held this gate with a whisper, not a wall: keep the signal alive.",
        "Say it once and you are one of us. Keep the signal alive.",
        "Light both pylons before you touch the Anchor — a quorum will not open for half a promise.",
        "The guardian in the plaza watches the great gate. The colonnade shadows do not watch back.",
        "When the Anchor settles, finality spreads. Out here we just call it morning."
      ]
    }
  ],
  "builds": [
    {
      "kind": "turret",
      "cost": 10
    },
    {
      "kind": "barricade",
      "cost": 4
    },
    {
      "kind": "turret",
      "cost": 10
    },
    {
      "kind": "barricade",
      "cost": 4
    },
    {
      "kind": "pylon",
      "cost": 15
    },
    {
      "kind": "pylon",
      "cost": 15
    }
  ],
  "gate": {
    "need": 2
  },
  "intro": [
    {
      "title": "Chapter VI — Final Settlement",
      "lines": [
        "Three rings of stone stand between the expedition and the great Settlement Anchor.",
        "The Entropy garrisons every wall it ever broke.",
        "One last march. Keep the signal alive."
      ],
      "art": "settlement"
    }
  ],
  "outro": [
    {
      "title": "The Anchor Settles",
      "lines": [
        "Light walks outward from the plaza, ring by ring.",
        "Finality spreads across the frontier like a slow dawn.",
        "The land remembers itself."
      ],
      "art": "dawn"
    },
    {
      "title": "Home",
      "lines": [
        "Wrenna's quorum sings. Tarn's odds finally come good.",
        "The settlement Anchor holds. The frontier is anchored for good — the expedition is home."
      ],
      "art": "anchorcraft"
    }
  ],
  "modifiers": {
    "waves": [
      {
        "at": 420,
        "letters": "rrssgg",
        "edge": "w"
      }
    ]
  },
  "tiles": [
    "##########################################################################################",
    "#_____________________#_._._._..............__....##,,,,,,,,,,,,,,,,,,,,##;;;;;;;;;;;;;;;#",
    "#_____________________#.......__.._._.._..__.__.._##,,,,,,,,,,,,,,,,,,,,##;;;;;T;;;;;;;;;#",
    "#_____________________#_._...._.....__......_...._##,,,,,,,,,,,,,,,,,,,,##;;;TTTT;TT;TT;;#",
    "#_____________________#._......_.............#....##,,,,,,,,,,,,,,,##,,,##;;;;TTT;;;;TT;;#",
    "#___________________T_#......__.....__...._.###...##,,,,,,,,,,,,,,,,,,,,##;;;;;;;T;TT;T;;#",
    "#___________________T_#.___._.._._..._....__.#._..##,,,,,,,,,,,,,,,#,,,,##;;;;;;;;;;;;;;;#",
    "#_____________________#_....g......_._...._###.#..##,,,,,,,,,,,,,,,,,,,,##;;;;;;;;TTT;;;;#",
    "#___________________T_#_.___.............._.##.._.##,,,,,,,,#,,,,,,,,,,,##;;;;;;;;TTT;TT;#",
    "#___________________T_#......_...___..__._...#_...##,,,,,,,,#########,,,##;;;;;;;;;TTTT;;#",
    "#______________________.._._.....__.._....#._#._..##,,,,,,,#,#,,,,,#,#,,##;;;;;;;;;;;;;;T#",
    "#___________________T__._...#.#._..._..._._#.#_...##,,,,,,,###,gcg,##,,,##;;;;;;;;;;;T;;;#",
    "#___________________T_#.g.....##_#...._...#.......##,,,,,,,,,#,,,,,###,,##;;;;;;;;;;;;;;;#",
    "#_____g_______________#.....####....._...###.._.__##,,,,,,,,,###,###,,,,##;;;;;;;;;;;;;;;#",
    "#___________________T_#_.._.TTTT.TTTT_TTTT#TT.._..##,,,g,,,,,,,,,,,,,,,,##;;;;;;;;;;;;;;;#",
    "#___________________T_#......#.._...._..____._.___##,,,,,,,,,,,,,,,,,,,,##;;;;;;;;;;;;;;;#",
    "#_____________________#._......#__..............._##,,,Y,,,,,,,,,,,,,,,,##;;;;;;;;;;;;;;;#",
    "#___________________T_#...__.........__.._...__...##,,,,,,,,,,,g,,#,#,,,##;;;;;;;;;;;;;;;#",
    "#____________##_____T_#........._._...._..Y.._._..##,,,,#,,,,,,,,,,,#,,,,,;;;;;;;;;;;;;;;#",
    "#____________##_______#....__..__........._._.....##,,,,#,,,,,,,,#,#g,,g,,;;;;;;;;;;;;;;;#",
    "#____________#______T_#.__._............_.........##,,TTT,TTTTT,TTTTT,,,##;;;;Y;;;;;;g;;;#",
    "#___________________T_#.._._.__.....___...........##,,,,,,,g,,,n,,#,#,,,##;;;#;;;#;;;;;;;#",
    "#________Y____________#..._......._........_..._..##,,,,,,,,,,,,,,,,,,,,##;;;;;;n;;;;;;;;#",
    "#________#__________T_#.####Y.............__.._#####,,,,,,,,,,,g,,,,,,,,##;;;g;;;;;;;g;;;#",
    "#_______####______o_T_#.####........._...__.._#o#.##,,n,,,,,r,,,,,,,,og,##;;;;;;;;;;;;g;;#",
    "#______#_##_______o___#__..n##_...._._....._...o####,,,,,,,,,,,,,,,,,o,,##;;;;;;;;;;;;;;;#",
    "#________###______o___#__####..................o_.##,,,,,,,,,,,,Y,,,,o,,##;;;#go;;;;;;;;;#",
    "#____g___##___________#..g.#.........._.........._##s,,,,,,,,,,,,,,,,,,,##;;g;;o;;;;;;;;;#",
    "#__P_P___#_g___________............###....._....._..,###B,,,,,,,,,,,,,g,,,;;;;;;;;;;;;g;;#",
    "#_______g___________B__.s_......._.###._....._._..._,,,b#,,,,,,,,,,,,,,,,,;s;;;;;;;;EE;;;#",
    "#________#_____________.............#...r._....____.,,###,,,,##,,,r,,,,,,,;;B;;;;b;;EE;;;#",
    "#__P_P___#####________#..g.......N*#_............B##,s,,,,,,,,,,,,,,N*g,,,;s;;;;;;;;;;;;;#",
    "#_________####________#...B......._......._...._..##,,,,,,,,,,,,,,,,,,,,##;;;;;;;;;;;;;;;#",
    "#___________##____o___#....._..........__..._..o._##,,B,,,,,,,,,,,,,,o,,##;;;;;o;;;;;;;;;#",
    "#_________________o___#..........g.............o..##,,,,,,,,,,,,,,,,,o,,##;;;#;o;;;;;;;;;#",
    "#_________________o___#...._...._.....__....._.o._##,,,,,,,,,,,,,,,,,o,,##;;;;;;;;;;;;;;;#",
    "#___________________T_#__......_..._..............##,,,,,m,,r,,,,,,,Y,,,##;;;;;;;;;;;;;;;#",
    "#___________g_________#_...._........_....___._.._##,,,,,,,,,,,,,,,,,,,,##;;;;;;;;;;;;;;;#",
    "#___________Y_______T_#____....._Y..._............##,,,,,,,,,g,g,,,,,,,,##;;;;;;g;;;;;;;;#",
    "#___________________T_#..........g......._.._._...##,,,,,,,,,,,,,,,,,,,,##;;;#;;;#;;;;;;;#",
    "#__________g_g________#................__..._.....##,,TTT,TTTTT,TTTTT,,,##;;;;Y;;;;;;;;;;#",
    "#___________________T_#.._.....#....._......g_#...##,,,,,,,,,,,,,,,,,,,,##;;;;;;;;;;;;;;;#",
    "#___________________T_#.._........_.....__._.####_##,,,,,,,,,,,,,,,,,,,,##;;;;;;;;;;;;;;;#",
    "#___________g_________#........#_..g.#..#..._##_..##,,,,,,,,,,,,,,m,,,,,##;;;;;;;;;;;;;;;#",
    "#___________________T_#......_.##.._..###...Y.._..##,,,,,,Y,,,,,,,,,,,,,##;;;;;;;;;;;;;;;#",
    "#___________________T_#_...._#..#_._..##......_.._##,,,,,,,,,,,,,,,g,,,,##;;;;;;;;;;;;;;;#",
    "#_____________________#_.._.TTTT.TTTT.TTTT.TT._...._,,,,,,,,,,,,,,,,,,,,##;;;;;;;;;;;;;;;#",
    "#_________________#_T_#.._...........##.#..._..___..,,,,,,,,,,,,,,,,,,,,##;;;;;;;;;;;;;;;#",
    "#___________________T__...._...........#......_.._##,,,,,,,#,,,,,,,,,,,,##;;;;TTT;;;TT;T;#",
    "#_______________#_#____..........g........_._._...##,,,,,,,,#,,,,,,,,,,,##;;;TTTTTT;;;;T;#",
    "#___________________T_#...........g........._.....##,,,,,,##,,,,,,,,,,,,##;;;;;;;;TT;;;;;#",
    "#___________________T_#.....___._...._............##,,,,,,,,g,,,,,,,,,,,##;;;;;;;TTTT;;;;#",
    "#_____________________#...._._..........#...___._.##,,,,,,,,,,,,,,,,,,,,##;;;;;;;;;;;;;;;#",
    "#___________________T_#.....g__..g....._..##.__...##,,,,,,,,,,,,,,,,,,,,##;;;;;;;;;;;;;;;#",
    "#___________________T_#.__..._......._...#._.._._.##,,,,,,,,,,,,,,,,,g,,##;;;;;;;;;;;;;;;#",
    "#_____________________#....._......_._...._.._....##,,,,,,,,,,,,,,,,,,,,##;;;;;;;;T;;;;;;#",
    "#___________________T_#.__.._...._................##,,,,,,,,,,,,,,,,,,,,##;;;;;;;;T;T;;;;#",
    "#_____________________#_........._...._....._.....##,,,,,,,,,,,,,,,,,,,,##;;;;;;;;T;T;;;;#",
    "#_____________________#......__...._............._##,,,,,,,,,,,,,,,,,,,,##;;;;;;;;;;;;;;;#",
    "##########################################################################################"
  ]
}
