{
  "name": "The Last Bastion",
  "objective": "Hold the bastion through five nights — the core must still stand at the fifth dawn",
  "time": 600,
  "expedition": true,
  "mode": "bastion",
  "bastion": {
    "nights": 5,
    "dayLen": 90,
    "nightLen": 75,
    "bloodMoons": [
      3,
      5
    ]
  },
  "intro": [
    {
      "title": "The Last Bastion",
      "lines": [
        "One bastion still answers on the frontier band: five nights from relief.",
        "Every dusk the Entropy marches a lane. Two moons will rise blood.",
        "Wall the gaps. Crew the towers. The core must not fall."
      ],
      "art": "siege"
    }
  ],
  "outro": [
    {
      "title": "The Fifth Dawn",
      "lines": [
        "The fifth dawn breaks over chewed walls and a core still humming.",
        "Relief columns crest the lanes the waves came down.",
        "The frontier holds — because this one did."
      ],
      "art": "dawn"
    }
  ],
  "captiveChars": [],
  "builds": [
    {
      "kind": "barricade",
      "cost": 4
    },
    {
      "kind": "barricade",
      "cost": 4
    },
    {
      "kind": "turret",
      "cost": 10
    },
    {
      "kind": "barricade",
      "cost": 4
    },
    {
      "kind": "barricade",
      "cost": 4
    },
    {
      "kind": "farm",
      "cost": 6
    },
    {
      "kind": "farm",
      "cost": 6
    },
    {
      "kind": "turret",
      "cost": 10
    },
    {
      "kind": "farm",
      "cost": 6
    },
    {
      "kind": "farm",
      "cost": 6
    },
    {
      "kind": "barricade",
      "cost": 4
    },
    {
      "kind": "barricade",
      "cost": 4
    }
  ],
  "chests": [
    {
      "loot": "medkit",
      "amount": 1
    },
    {
      "loot": "shards",
      "amount": 8
    },
    {
      "loot": "cracker",
      "amount": 2
    },
    {
      "loot": "token",
      "amount": 1
    },
    {
      "loot": "token",
      "amount": 1
    },
    {
      "loot": "shards",
      "amount": 12
    },
    {
      "loot": "shield",
      "amount": 1
    },
    {
      "loot": "shield",
      "amount": 1
    },
    {
      "loot": "shield",
      "amount": 1
    },
    {
      "loot": "shards",
      "amount": 7
    },
    {
      "loot": "shards",
      "amount": 9
    },
    {
      "loot": "medkit",
      "amount": 1
    },
    {
      "loot": "cracker",
      "amount": 2
    }
  ],
  "vehicles": [
    {
      "kind": "skiff"
    },
    {
      "kind": "stag"
    },
    {
      "kind": "stag"
    }
  ],
  "hires": [
    {
      "job": "farmer",
      "cost": 8,
      "name": "Sage Imbra"
    },
    {
      "job": "engineer",
      "cost": 10,
      "name": "Wrench Odal"
    },
    {
      "job": "smith",
      "cost": 12,
      "name": "Forgemaster Hesk"
    }
  ],
  "tiles": [
    "####################################################################################",
    "#,,.,,,,,,,,,.,..,,,...,..,,,,,,...................................................#",
    "#,.,,,,,,,,,,.,,,,TTT,,TT,..T,.,..................#.#..............................#",
    "#.,,,..,,,,.,,,,,T,TT,TT.TT,,..,..................###C......a......................#",
    "#.,,,,,,T,..,,,,,,TTTT,,T,T,,,T............#....#.####.........:::::::.............#",
    "#,,,,TTTC,,,,,,.,,,T,TTTTT,.TT.,...........##....##..#.......::~~~~~~~::...........#",
    "#,,..TTTTT,,,,,,.,T,,C,,T,T,TT,.............#...........g...:~~~~~~~~~~~:..........#",
    "#,.,,TTT,T,,.,,,,,,..,.,TT,T.,,............##..............:~~~~~~~~~~~~~:.....C...#",
    "#,,.,T,TTTT,.,,.,,,,TT,..gT,TT,,........#..#.#...........#:~~~~~~~~~~~~~~~:........#",
    "#.,.,,,,TT,T,,,.,,TT,,T,,.,.,T,,.............#...........#:~~~~~~~~~~~~~~~:...###..#",
    "#.,TT,TT,,g..,,,,TTTw,,,,.,.,,,,...........Y.............#~~~~~~~:::~~~~~~~:....##.#",
    "#.,TTT,,,,,,,,.,TTTTTT,T,,,,,,,,...........#.............#~~~~~~:C,C:~~~~~~:.#n##..#",
    "#.,,,T,,,,,.,,,.T,,TTT,,a.,,,,.,...........#.............:~~~~~~:,,,:~~~~~~:..####.#",
    "#,.,,,,.,.,,,,,,,,.T,,,,,,,...,............#.............:~~~~~~:,C,:~~~~~~:.#.##..#",
    "#.,,,,,,,,,,,.,,,,gTTT.,,.,,,,,..........................:~~~~~~~:::~~~~~~~#.#.....#",
    "#,,,,,,,,..,,,,Y.,T,T,.,,,,,,,,,..........................#~~~~~~~~~~~~~~~#.#......#",
    "#,,,.,,TT.,,w,,,,,,.T,,,,,,,,,.,.........Y................V~~~~~~~~~~~~~~~#.a......#",
    "#,,,T,.TT,,.,,,...,TT,,.,,.,.,,,...........................:~~~~~~~~~~~~~###.......#",
    "#,.,TTTTT,.,,,.,TT,,,,,,,,.,,.,,............................:~~~~~~~~~~~#...#......#",
    "#,.,,T.TT,.,,,.,T,TTT,,,,,,,,,,,.............................::~~~~~~~::...#.......#",
    "#,,TTT..T.,,,.g,,.,T,,,,.,,,,.,,...............................:::::::.............#",
    "#,T,TTT.,T.,.,,,,TTT,,..,,,,,,,,...................................................#",
    "#.T,T,TTT,,,,,.,,,,,,,.,,,,,,,,........o....o.........................g............#",
    "#.,,TTT,,,.,,,,,.,,,,,.,.,,,,,,,...................................................#",
    "#....T.T........#...............#########BB##########..............................#",
    "#................#..............#;;;;;;;;;;;;;;;;;;;#..............................#",
    "#.............#.##..............#;W;;;;;;;;;;;;;;;W;#..............................#",
    "#...............#...............#;;;;;;;;;;;;;;;;;;;#..............................#",
    "#...............................#;;;;;B;;;;;;;S;;;;;#..............................#",
    "#...............................#;;;;;;;;;*;;;;;;;;;#..............................#",
    "#....C........................o.#;;;;;;;P;;;P;;;;;;;#.o..#.........................#",
    "#...........Y...................#;;H;;;;;;;;;V;;;;;;#.......Y.................Y....#",
    "#...............................B;;;;;;;;;K;;;;;;;;;B..............................#",
    "#...................Y...........#;;H;;;;;;;;;V;;;;;;#..#..............Y.....C.#....#",
    "#.............................o.#;;;;;;;P;;;P;;;;;;;#.o..#....................##...#",
    "#...............................#;;H;;;;;;*;B;B;;;;;#..##.................#.###.#..#",
    "#...............................#;;;;;B;;;;;;;;;;;;;#.....................##.#.....#",
    "#...............................#;;;;;;;;;;;B;B;;;;;#.......................##.#...#",
    "#.......r.......................#;W;;;;;;;;;;;;;;;W;#.......................#......#",
    "#...............................#;;;;;;;;;;;;;;;;;;;#..............................#",
    "#........................##.....#########BB##########...........#..................#",
    "#::.::.::::::::..::::::.:##:..::.....................___.__._.__._##._____.__.__.._#",
    "#:::.::::::::::::.:.:.::::##::::.......o....o........_______.._#_###.______..___.__#",
    "#..:.:::::::::..::::.:..::::::::....................._______.___.#_#__##._________.#",
    "#:..::::..g::::::..::.:::::.::::....................._.___.__.._.#_#####._s._______#",
    "#.::::.:::~~~:::.:.::::::::.::.:....................._#...#_._.__#_#.####____..__._#",
    "#::.:.:::~~:~:.::..:##::..:::..:....................._..#_#_.._.__g._Y_.___.__a_._.#",
    "#:::::::~:~:::::::::#:.:::.:.:::.......##............____##.______._.#_#_.._.______#",
    "#::.:::.::::::.:::..:.:::.:..:###.......#Y.....#....._###.._________._#.___#_______#",
    "#:::.::::.:..::.:~:.:.:::.::.#:##.......#......#....._____#Y____._##_____._.______.#",
    "#.:..::::..:::w:~~:.:::::....###....................._._#._.####_#______._#._______#",
    "#:::..:.:::..::#~:::..:.::::::::.....................__.._#_##_##___##___._###__.__#",
    "#.:.::::C:.:.##::.:.:.:.::::...:......................._._a####__###_.r___##__C____#",
    "#.::::.:::::.#.#####r.::::.:.::......................___..##_##_##_#.#___.#__.._.._#",
    "#.:.::::::::::::#:#:::~::.::::.:..........Y#........._____r###_###._______.#.____._#",
    "#.::.:.::..:::#::.:::~~~:::.:.::...........#..#......___.___######s#_______..__.__.#",
    "#::::.:~::::::.#g.#.:~~~~::::::............###......._____..######..#.___.____..__.#",
    "#:.:::a~~::.::...::::::~::C:::.:........#..##........__._C____.#__##___._..___._n__#",
    "#:.:::~~~::::::.:.::::::::::..::............##......._.____.__#_#_#____.____g_____.#",
    "#:::.::~::::..:::::::...:..:.:::........#....#......._....___#_____._____.________.#",
    "#::.::.:.:::::.::...:.:.w:::..::...........#..........___._______.__._._###_______.#",
    "#:::::.::.:.::.::::::::::::::.:......................__..__.___._____._._###__._.__#",
    "#:::::::..::..::::::::.:::..::::......................__..___________.____.____.___#",
    "####################################################################################"
  ]
}
