{
  "name": "Twin Relays",
  "title": "Versus — Twin Relays",
  "objective": "Steal the enemy banner and run it home — first to 3 captures takes the field",
  "time": 480,
  "mode": "ctf",
  "expedition": true,
  "captiveChars": [],
  "chests": [
    {
      "loot": "cracker",
      "amount": 2
    },
    {
      "loot": "cracker",
      "amount": 2
    },
    {
      "loot": "shield",
      "amount": 1
    },
    {
      "loot": "shield",
      "amount": 1
    },
    {
      "loot": "shards",
      "amount": 8
    },
    {
      "loot": "shards",
      "amount": 8
    }
  ],
  "vehicles": [
    {
      "kind": "stag"
    },
    {
      "kind": "stag"
    }
  ],
  "tiles": [
    "################################################################",
    "#..............................................................#",
    "#.............................;;;;.............................#",
    "#_...._......._...............;;;;..............._......._...._#",
    "#......._..........T;;....##..;;;;..##....;;T.........._.......#",
    "#..................T;;....##..;;;;..##....;;T..................#",
    "#...................;;..C.....;;;;.....C..;;...................#",
    "#......_..........T.;;....T...;;;;...T....;;.T.........._......#",
    "#...................;;.......o;;;;o.......;;...................#",
    "#......_.._.....T...;;.......o;;;;o.......;;...T....._.._......#",
    "#...................;;........;;;;........;;...................#",
    "#......_............;;........;;;;........;;............_......#",
    "#######..######..###;;######..;;;;..######;;###..######..#######",
    "#;;;;;;;;;;;;;#...._;;..T.....;;;;.....T..;;_....#;;;;;;;;;;;;;#",
    "#;;;;;;;;;;;;;#...T.;;........;;;;........;;.T...#;;;;;;;;;;;;;#",
    "#;;;;;;;;;S;;;#.....;;........;;;;........;;.....#;;;S;;;;;;;;;#",
    "#;;P;;;;;;;;;;#.._..;;..##....;;;;....##..;;.._..#;;;;;;;;;;P;;#",
    "#;;;;;;;;;;;;;#.....;;..##....;;;;....##..;;.....#;;;;;;;;;;;;;#",
    "#;;;;;;;;;;;;;#.o...;;........V;;V........;;...o.#;;;;;;;;;;;;;#",
    "#;;P;;;;;;;;;;#..o..;;........;;;;........;;..o..#;;;;;;;;;;P;;#",
    "#;;;;;;;;;;;;;.._...;;._...o..;;;;..o..._.;;..._..;;;;;;;;;;;;;#",
    "#;;;;D;;;;;;;;;;;;;;;;;;;;;;;;;CC;;;;;;;;;;;;;;;;;;;;;;;;;D;;;;#",
    "#;;;;;;;;;;;;;;;;;;;;;;;;;;;;;;;;;;;;;;;;;;;;;;;;;;;;;;;;;;;;;;#",
    "#;;;;;;;;;;;;;......;;.....o..;;;;..o.....;;......;;;;;;;;;;;;;#",
    "#;;P;;;;;;;;;;#..o..;;........;;;;........;;..o..#;;;;;;;;;;P;;#",
    "#;;;;;;;;;;;;;#.o...;;........;;;;........;;...o.#;;;;;;;;;;;;;#",
    "#;;;;;;;;;;;;;#.....;;..##....;;;;....##..;;.....#;;;;;;;;;;;;;#",
    "#;;P;;;;;;;;;;#.....;;..##..._;;;;_...##..;;.....#;;;;;;;;;;P;;#",
    "#;;;;;;;;;;;;;#.....;;........;;;;........;;.....#;;;;;;;;;;;;;#",
    "#;;;;;;;;;;;;;#.....;;........;;;;........;;.....#;;;;;;;;;;;;;#",
    "#;;;;;;;;;;;;;#.....;;........;;;;........;;.....#;;;;;;;;;;;;;#",
    "#######..######..###;;######..;;;;..######;;###..######..#######",
    "#...................;;........;;;;........;;...................#",
    "#...............T...;;.T......;;;;......T.;;...T...............#",
    "#...................;;....T..o;;;;o..T....;;...................#",
    "#...................;;.......o;;;;o.......;;...................#",
    "#.._................;;....T...;;;;...T....;;................_..#",
    "#......_............;;..C._...;;;;..._.C..;;............_......#",
    "#..................T;;....##..;;;;..##....;;T..................#",
    "#..................T;;....##..;;;;..##....;;T..................#",
    "#........_.......T.........T..;;;;..T.........T......._........#",
    "#......._.....................;;;;....................._.......#",
    "#..............................................................#",
    "################################################################"
  ]
}
