{
 "name": "Lake Picnic",
 "objective": "Walk around the big blue lake, rescue your buddy, and find the gate!",
 "family": true,
 "untimed": true,
 "time": 0,
 "weather": "clear",
 "ambience": "meadow",
 "captiveChars": [
  "medic"
 ],
 "tiles": [
  "####################################",
  "#..................................#",
  "#..................................#",
  "#......T........=====..............#",
  "#.......TT......=====..............#",
  "#........T......=====..............#",
  "#.....T.....g.................c....#",
  "#...............=====..............#",
  "#.............===~~~===............#",
  "#............==~~~~~~~==...z.......#",
  "#...P........=~~~~~~~~~=...........#",
  "#..P........==~~~~~~~~~==..........#",
  "#..P........==~~~~~~~~~==........E.#",
  "#...P.......==~~~~~~~~~==..........#",
  "#............=~~~~~~~~~=...........#",
  "#............==~~~~~~~==...........#",
  "#.............===~~~===............#",
  "#......T..z.....=====.......TT.....#",
  "#.....TTTT..............g..........#",
  "#...............=====.......T......#",
  "#...............=====.......T..T...#",
  "#...............=====.........T....#",
  "#..................................#",
  "####################################"
 ]
}