{
  "stranded": true,
  "name": "Crater Vigil",
  "objective": "Seize the void-rimmed spire across the causeways, then hold the crater six nights as casters snipe from across the chasm and phaseborn ghost through the walls",
  "time": 720,
  "expedition": true,
  "mode": "bastion",
  "theme": "voidscar",
  "bastion": {
    "nights": 6,
    "dayLen": 120,
    "nightLen": 60,
    "bloodMoons": [
      3,
      6
    ],
    "wavesPerNight": 1,
    "waveMult": 1.85,
    "roster": [
      "h",
      "a",
      "y",
      "n",
      "k"
    ],
    "edges": [
      "s"
    ],
    "dayEvents": true
  },
  "capture": {
    "x": 40,
    "y": 5,
    "radius": 3,
    "duration": 90,
    "threshold": 1,
    "decay": 1,
    "contest": true
  },
  "stronghold": {
    "level": 21,
    "name": "Crater Vigil",
    "sizeLabel": "XL",
    "difficulty": 5,
    "waves": 8,
    "hpMult": 1.6,
    "blurb": "A capture spire marooned on a top-center plateau, ringed by bottomless void. Two thread-thin causeways are the only way up. Take the spire, then hold six nights while casters rake you from islands you cannot reach and phaseborn drift straight through the chasm walls.",
    "newFeatures": [
      "King-of-the-hill spire capture",
      "Void chasms eat your shots",
      "Phaseborn ghost through walls"
    ]
  },
  "intro": [
    {
      "title": "Crater Vigil",
      "lines": [
        "The spire stands on a shelf of cracked slab, marooned over a void that has no floor.",
        "Two causeways reach it. One shove and you are a long, screaming detour from the fight.",
        "Take the high stone. Then hold it six nights while the dark across the chasm aims back."
      ],
      "art": "entropy"
    }
  ],
  "outro": [
    {
      "title": "The Spire Holds",
      "lines": [
        "Six dawns over the crater and the causeways still bear weight.",
        "Across the void the casters have gone quiet. The vigil is yours."
      ],
      "art": "dawn"
    }
  ],
  "captiveChars": [],
  "tiles": [
    "################################################################################",
    "#//////////////////////////////////////////////////////////////////////////////#",
    "#///////////////////%%%%%%%%%%%%#;;;;;;;;;;;;;;;#%%%%%%%%%%%%//////////////////#",
    "#///////////////////%%%%%%%%%%%%#;B;;;;;K;;;;;B;#%%%%%%%%%%%%//////////////////#",
    "#///////////////////%%%%;;;;%%%%#;;;;;;;;;;;;;;;#%%%%;;;;%%%%//////////////////#",
    "#///////////////////%%%%;a;;%%%%#;;;;;;;;;;;;;;;#%%%%;;a;%%%%//////////////////#",
    "#///////////////////%%%%;;y;%%%%#;;;;;;;;;;;;;;;#%%%%;y;;%%%%//////////////////#",
    "#///////////////////%%%%;;;;%%%%#;;B;;;;;;;;;B;;#%%%%;;;;%%%%//////////////////#",
    "#///////////////////%%%%%%%%%%%%#;BB;;BBBBB;;BB;#%%%%%%%%%%%%//////////////////#",
    "#///////////////////%%%%%%%%%%%%####;;#####;;####%%%%%%%%%%%%//////////////////#",
    "#///////////////////////k/////k/////;;//k//;;/////k/////k//////////////////////#",
    "#///////////////////////////////////;;/////;;//////////////////////////////////#",
    "#/////////%%%%%%%///////////////////h;/////;h///////////////////%%%%%%%////////#",
    "#/////////%;;;y;%/////////////////;;;;;;//;;;;;;////////////////%;y;;;%////////#",
    "#/////////%;;n;;%/////////////////;;;;;;//;;;;;;////////////////%;;n;;%////////#",
    "#/////////%;;;a;%/////////////////;h;;;;//;;;;h;////////////////%;a;;;%////////#",
    "#/////////%;;;;;%///////////////////////////////////////////////%;;;;;%////////#",
    "#/////////%;;;;;%///////////////////////////////////////////////%;;;;;%////////#",
    "#/////////%%%%%%%///////////////////////h///////////////////////%%%%%%%////////#",
    "#//////////////////////////////////////////////////////////////////////////////#",
    "#////////////////////////////////h/////////////h///////////////////////////////#",
    "#//////////////////////////////////;;;;;;;;;;;/////////////////////////////////#",
    "#///////////////////////%%%%%//////;;;;;P;;;;;//////%%%%%//////////////////////#",
    "#///////////////////////%%%%%//////;;;P;;;P;;;//////%%%%%//////////////////////#",
    "#///////////////////////%%%%%//////;;;;;P;;;;;//////%%%%%//////////////////////#",
    "#///////////////////////%%%%%//////;*;;;;;;;*;//////%%%%%//////////////////////#",
    "#///////////////////////%%%%%//////;;;;;/;;;;;//////%%%%%//////////////////////#",
    "#//////////////////////////////////////////////////////////////////////////////#",
    "#///////////////////C///////////////////S//////////////////C///////////////////#",
    "#//////////////////////////////////////////////////////////////////////////////#",
    "#/////%%%%%%%%%///////////////////////////////////////////////////%%%%%%%%%////#",
    "#/////%%%%%%%%%///////////////////////////////////////////////////%%%%%%%%%////#",
    "#/////%%%%%%%%%///////////////////////////////////////////////////%%%%%%%%%////#",
    "#/////%%%%%%%%%///////////////V//////////////////V////////////////%%%%%%%%%////#",
    "#/////%%%%%%%%%///////////////////////////////////////////////////%%%%%%%%%////#",
    "#/////%%%%%%%%%///////////////////////////////////////////////////%%%%%%%%%////#",
    "#/////%%%%%%%%%///////////////////////////////////////////////////%%%%%%%%%////#",
    "#/////////////////////////////////////////////////////////////////%%%%%%%%%////#",
    "#/////////////////////////////////%%%%%%/%%%%%%////////////////////////////////#",
    "#/////////////////////////////////%%%%%%/%%%%%%////////////////////////////////#",
    "#/////////////////////////////A///%%%%%%/%%%%%%//A/////////////////////////////#",
    "#/////////////////////////////////%%%%%%/%%%%%%////////////////////////////////#",
    "#/////////////////////////////////%%%%%%/%%%%%%////////////////////////////////#",
    "#/////////////////////////////////%%%%%%/%%%%%%////////////////////////////////#",
    "#/////////////////////////////////%%%%%%/%%%%%%////////////////////////////////#",
    "#/////////////////C//////////////////////////////////////////C/////////////////#",
    "#//////////////////////////////////////////////////////////////////////////////#",
    "#//////////////////////////////////////////////////////////////////////////////#",
    "#//////////////////////////////////////////////////////////////////////////////#",
    "################################################################################"
  ],
  "builds": [
    {
      "kind": "wall",
      "cost": 5,
      "prebuilt": true,
      "level": 2
    },
    {
      "kind": "wall",
      "cost": 5,
      "prebuilt": true,
      "level": 2
    },
    {
      "kind": "turret",
      "cost": 10,
      "prebuilt": true,
      "ttype": "prism"
    },
    {
      "kind": "turret",
      "cost": 10,
      "prebuilt": true,
      "ttype": "prism"
    },
    {
      "kind": "wall",
      "cost": 5,
      "prebuilt": true,
      "level": 2
    },
    {
      "kind": "wall",
      "cost": 5,
      "prebuilt": true,
      "level": 2
    },
    {
      "kind": "wall",
      "cost": 5,
      "prebuilt": true,
      "level": 2
    },
    {
      "kind": "wall",
      "cost": 5,
      "prebuilt": true,
      "level": 2
    },
    {
      "kind": "wall",
      "cost": 5,
      "prebuilt": true,
      "level": 2
    },
    {
      "kind": "wall",
      "cost": 5,
      "prebuilt": true,
      "level": 2
    },
    {
      "kind": "wall",
      "cost": 5,
      "prebuilt": true,
      "level": 2
    },
    {
      "kind": "wall",
      "cost": 5,
      "prebuilt": true,
      "level": 2
    },
    {
      "kind": "wall",
      "cost": 5,
      "prebuilt": true,
      "level": 2
    }
  ],
  "chests": [
    {
      "loot": "shards",
      "amount": 10
    },
    {
      "loot": "medkit",
      "amount": 1
    },
    {
      "loot": "shield",
      "amount": 1
    },
    {
      "loot": "shards",
      "amount": 9
    }
  ],
  "hires": [],
  "vehicles": [
    {
      "kind": "stag"
    },
    {
      "kind": "stag"
    }
  ],
  "pickups": [
    {
      "kind": "railcannon"
    },
    {
      "kind": "stormgun"
    }
  ]
}
