{
  "name": "Outer Barricade",
  "objective": "Break the first cordon and extract the pinned marksman.",
  "time": 90,
  "captiveChars": ["sniper"],
  "tiles": [
    "####################",
    "#......EE..........#",
    "#..o...........o...#",
    "#..g......c....g...#",
    "#....oo##..##oo....#",
    "#..................#",
    "#..a............a..#",
    "#...o..........o...#",
    "#....g........g....#",
    "#..................#",
    "#..o............o..#",
    "#..................#",
    "#....P..P..P..P....#",
    "####################"
  ]
}
