{
  "name": "Floodgate Run",
  "objective": "Cross the coolant channels before the chargers split the squad.",
  "time": 100,
  "captiveChars": ["raider"],
  "tiles": [
    "####################",
    "#........EE........#",
    "#..g......r....g...#",
    "#~~~~~~~..~~~~~~~~~#",
    "#......o....o......#",
    "#..a..........a....#",
    "#....g...##...g....#",
    "#........##....c...#",
    "#~~~..~~~~~~~~..~~~#",
    "#...o..........o...#",
    "#...r.....g....r...#",
    "#..................#",
    "#..........PPPP....#",
    "####################"
  ]
}
