{
  "name": "Black Battery",
  "objective": "Recover Atlas before the last gate opens.",
  "time": 145,
  "captiveChars": ["atlas"],
  "tiles": [
    "####################",
    "#...n....EE....n...#",
    "#.####..####..####.#",
    "#....m..s..s..m....#",
    "#.oo......c.....oo.#",
    "#.##..~~~~~~~~..##.#",
    "#.....r....r.......#",
    "#.##..~~~~~~~~..##.#",
    "#.oo....mmmm....oo.#",
    "#....s........s....#",
    "#..a....rrrr....a..#",
    "#..................#",
    "#..........PPPP....#",
    "####################"
  ]
}
