{
  "name": "Laser Alley",
  "objective": "Cross the open lanes under sniper overwatch.",
  "time": 120,
  "captiveChars": ["duelist", "volt"],
  "tiles": [
    "####################",
    "#...n....EE....n...#",
    "#..####......####..#",
    "#..o....c..c....o..#",
    "#......######......#",
    "#..s............s..#",
    "#..................#",
    "#..r....oooo....r..#",
    "#..................#",
    "#..a....m..m....a..#",
    "#....g........g....#",
    "#..................#",
    "#..........PPPP....#",
    "####################"
  ]
}
