{
  "name": "Signal Cradle",
  "objective": "Cut through the relay guards and recover Helix.",
  "time": 135,
  "captiveChars": ["helix"],
  "tiles": [
    "####################",
    "#........EE........#",
    "#..n....oooo....n..#",
    "#....s..####..s....#",
    "#..m...........m...#",
    "#......##c.##......#",
    "#~~~~..##..##..~~~~#",
    "#......##..##......#",
    "#..r...........r...#",
    "#....s..####..s....#",
    "#..a....oooo....a..#",
    "#..................#",
    "#..........PPPP....#",
    "####################"
  ]
}
