{
  "name": "Spawner Yard",
  "objective": "Silence the nests before the yard fills with skitters.",
  "time": 115,
  "captiveChars": ["bastion"],
  "tiles": [
    "####################",
    "#........EE........#",
    "#..m....o..o....m..#",
    "#......######......#",
    "#..g............g..#",
    "#....o..c...o......#",
    "#~~~~..####..~~~~..#",
    "#......####........#",
    "#..r............r..#",
    "#....s........s....#",
    "#..a............a..#",
    "#..................#",
    "#..........PPPP....#",
    "####################"
  ]
}
