{
  "name": "Switchback Vault",
  "objective": "Pull the disc runner out of the maze.",
  "time": 125,
  "captiveChars": ["boomer"],
  "tiles": [
    "####################",
    "#........EE........#",
    "#.####.######.####.#",
    "#.n....g..g....n...#",
    "#.####.o..o.####...#",
    "#......o..c..o.....#",
    "#..s..######..s....#",
    "#......o..o........#",
    "#.####.oooo.####...#",
    "#..r....m..m...r...#",
    "#....g........g....#",
    "#..................#",
    "#..........PPPP....#",
    "####################"
  ]
}
