{
  "name": "Core Holdout",
  "objective": "Defeat the command core or get everyone through the breach.",
  "time": 160,
  "captiveChars": [],
  "tiles": [
    "####################",
    "#........EE........#",
    "#..n....oooo....n..#",
    "#....s........s....#",
    "#..m....####....m..#",
    "#......o....o......#",
    "#..r.....b......r..#",
    "#......o....o......#",
    "#..m....####....m..#",
    "#....s........s....#",
    "#..n....rrrr....n..#",
    "#..................#",
    "#..........PPPP....#",
    "####################"
  ]
}
