{
  "name": "Foundry Spiral",
  "objective": "Extract the warden and shade from the hot floor.",
  "time": 130,
  "captiveChars": ["warden", "shade"],
  "tiles": [
    "####################",
    "#...n....EE....n...#",
    "#.####..oooo..####.#",
    "#.#....s....s....#.#",
    "#.#.~~~~.~~.~~~~.#.#",
    "#.#..c........c..#.#",
    "#.#.####.oo.####.#.#",
    "#.#....m....m....#.#",
    "#.#.~~~~.~~.~~~~.#.#",
    "#.#..r........r..#.#",
    "#.####..aaaa..####.#",
    "#..gg..........gg..#",
    "#..........PPPP....#",
    "####################"
  ]
}
