{
 "name": "Forest Friends",
 "objective": "Wander the woods, free your friend, and stroll to the gate!",
 "family": true,
 "untimed": true,
 "time": 0,
 "weather": "clear",
 "ambience": "meadow",
 "captiveChars": [
  "raider"
 ],
 "tiles": [
  "################################",
  "#..............................#",
  "#..............................#",
  "#..............................#",
  "#......................=====...#",
  "#.............TT......==~~~==..#",
  "#.............T.......==~~~==..#",
  "#............TT.......==~~~==..#",
  "#.........T...........g=====...#",
  "#...P....TT....................#",
  "#..P......T....................#",
  "#..P.....T......c............E.#",
  "#...P..........................#",
  "#..............................#",
  "#.....=====.g......T.TT........#",
  "#....==~~~==.............T.....#",
  "#....==~~~==.........T...T.....#",
  "#....==~~~==......z..T..TT.....#",
  "#.....=====............TT......#",
  "#..............................#",
  "#..............................#",
  "################################"
 ]
}