{
 "name": "Sunny Meadow",
 "objective": "Explore the meadow, help your friend, and reach the rainbow gate together!",
 "family": true,
 "untimed": true,
 "time": 0,
 "weather": "clear",
 "ambience": "meadow",
 "captiveChars": [
  "scout"
 ],
 "tiles": [
  "##################################",
  "#................................#",
  "#................................#",
  "#................................#",
  "#.....................=====......#",
  "#.................c..==~~~==.....#",
  "#......TTTT.........==~~~~~==....#",
  "#......T..T.........==~~~~~==....#",
  "#..........T........==~~~~~==....#",
  "#...P................==~~~==.....#",
  "#..P..................=====......#",
  "#..P...........................E.#",
  "#...P............................#",
  "#...........g....................#",
  "#............................T...#",
  "#....................g.....T.....#",
  "#............=====.........T.T...#",
  "#............=====...........T...#",
  "#............=====.........T.....#",
  "#................................#",
  "#................................#",
  "##################################"
 ]
}