{
  "stranded": true,
  "name": "Ashfall Survival",
  "objective": "No walls, no keep — endure four ashfall nights as molten fire eats the open plain. Read the burn and keep moving.",
  "time": 600,
  "expedition": true,
  "mode": "bastion",
  "theme": "emberwaste",
  "weather": "ashstorm",
  "bastion": {
    "nights": 4,
    "survival": true,
    "bloodMoons": [
      2,
      3,
      4
    ],
    "waveMult": 2.2,
    "wavesPerNight": 2,
    "roster": [
      "w",
      "u",
      "r",
      "d",
      "e"
    ],
    "dayEvents": true
  },
  "stronghold": {
    "level": 19,
    "name": "Ashfall Survival",
    "sizeLabel": "XL",
    "difficulty": 4,
    "waves": 14,
    "hpMult": 1.6,
    "blurb": "An open ashfall plain veined with lava. There is no fortress here — molten bruisers and pyre-beetles carpet the ground in spreading fire while ember-kites rain bolts. Safe footing shrinks every night; survival is constant relocation.",
    "newFeatures": [
      "Open-field survival — no core, no walls to hold",
      "Spreading burn patches from molten + beetle deaths",
      "Ember-kite ranged fire across exposed ground"
    ]
  },
  "ambience": "lava",
  "intro": [
    {
      "title": "Ashfall Survival",
      "lines": [
        "The basin is one vast ash flat, braided with living lava.",
        "No monolith to defend, no wall to mend — only the open ground.",
        "Molten things die in fire and leave fire behind. Stay still and you burn."
      ],
      "art": "basin"
    }
  ],
  "outro": [
    {
      "title": "Through the Embers",
      "lines": [
        "Four nights of fire and the column never let itself be cornered.",
        "The ashfall settles. What walked out of it kept walking the whole time."
      ],
      "art": "dawn"
    }
  ],
  "captiveChars": [],
  "tiles": [
    "################################################################################",
    "#______________________________________________________________________________#",
    "#______________________________________________________________________________#",
    "#______________________________________________________________________________#",
    "#______________________________________________________________________________#",
    "#_____________________________!!!!!!!__________________________________________#",
    "#___________________________!!_!!_!!_!!_________________________________!!_____#",
    "#____________#____________!!!!_______!!!!___________________________#_!!_!_____#",
    "#_________#######________!!___________##!!#________________________##!!!_______#",
    "#____________#e________!!!______________#!!!______________________#!!##________#",
    "#_________C___________!!___________________!!_____________________!!!#_________#",
    "#___________________!!!_____________________!!!_________________!!__#__________#",
    "#__________________!!______________r____*_____!!_______________!!!_____________#",
    "#________________!!!__________#________________!!!___________!!________________#",
    "#_____!!_______!!!___________#!#_________________!!!_______!!!!________________#",
    "#______!!!!!!!!_!______w____#!!##_________________!!!!!!!!!!___________________#",
    "#_______!_!!_!!_u____________#!#__________________!#!!#!!_!____________________#",
    "#_____________________#_______!___________________!_#__________________________#",
    "#___________________#####_u__!!___________________!!___________________________#",
    "#_____________________#_______!___________________!_____r______________________#",
    "#_____________________________!___________________!____*_+++___________________#",
    "#__________________+++______w!!________________w__!!__++++++u++________________#",
    "#________________+++d+++______!________+++________!__+++++++++++_______________#",
    "#_______________+++++++++_____!______+++++++______!__+++++++++++_______________#",
    "#_______________+w+++++++___________+++++++++_______+++++++++++++______________#",
    "#_________*____+++++++++++_______C__+++P+P+++__C__A_A+++++++++++______*________#",
    "#_______________+++++++++_____!_____+++P+P+++_____!__+++++++++++_______________#",
    "#_______________+++++++++____!!______+++++++______!!__++++d++++________________#",
    "#________________+u+++++______!________+++________!w_____+++_w_________________#",
    "#__________________+++________!___________________!____________________________#",
    "#_____________________r__*___!!__w______C_H_H_H___!!___________________________#",
    "#_____________________________!___________________!_________#__________________#",
    "#___________!___!_____________!___________________!_u_____##!##_!______________#",
    "#_______!!!!!!!!!_______d____!!___________________!!__d#____!!!!!!!_!__________#",
    "#______!!________!!_!_________!___________________!__###!!!!_______!!!_________#",
    "#_____!____________!!_______#_!___________________!_###!!##___________!!!______#",
    "#____________________!!_!_#####_____________________!!!###____u_________!______#",
    "#______________________!!___#_______________________!__#_________________!_____#",
    "#________________________!______________*____r__!_!!_____w_____________________#",
    "#_________C_#e____________!!!___________________!!___________________C_________#",
    "#_________#####_____________!!__________d______!_______________________________#",
    "#___________#_________________!!!_______#___!!!__________________e#____________#",
    "#_______________________________!!!_!_##!#!!!___________________#####__________#",
    "#__________________________________!!!!!!!________________________#____________#",
    "#______________________________________________________________________________#",
    "#______________________________________________________________________________#",
    "#______________________________________________________________________________#",
    "#______________________________________________________________________________#",
    "#______________________________________________________________________________#",
    "################################################################################"
  ],
  "chests": [
    {
      "loot": "shards",
      "amount": 14
    },
    {
      "loot": "medkit",
      "amount": 1
    },
    {
      "loot": "shards",
      "amount": 12
    },
    {
      "loot": "shield",
      "amount": 1
    },
    {
      "loot": "cracker",
      "amount": 2
    },
    {
      "loot": "shards",
      "amount": 10
    }
  ],
  "hires": [
    {
      "job": "farmer",
      "cost": 10,
      "name": "Cinder Ostre"
    },
    {
      "job": "engineer",
      "cost": 10,
      "name": "Wrench Lumen"
    },
    {
      "job": "smith",
      "cost": 12,
      "name": "Fletch Sorin"
    }
  ],
  "pickups": [
    {
      "kind": "flamer"
    },
    {
      "kind": "mortarMk2"
    }
  ]
}
