{
 "name": "Anchorline",
 "objective": "Push a lane, break their towers, and shatter the enemy Anchor core.",
 "mode": "siege",
 "expedition": true,
 "untimed": true,
 "siege": {
  "coreHp": 60,
  "minionInterval": 20,
  "minionCap": 12,
  "waveBase": 3,
  "wavePerMin": 1,
  "lanes": [
   {
    "waypoints": [
     [
      6,
      41
     ],
     [
      24,
      44
     ],
     [
      44,
      44
     ],
     [
      44,
      24
     ],
     [
      41,
      6
     ]
    ]
   },
   {
    "waypoints": [
     [
      6,
      41
     ],
     [
      4,
      24
     ],
     [
      4,
      4
     ],
     [
      24,
      4
     ],
     [
      41,
      6
     ]
    ]
   }
  ]
 },
 "towers": [
  {
   "x": 26,
   "y": 44,
   "team": 0,
   "lane": 0,
   "level": 1
  },
  {
   "x": 39,
   "y": 44,
   "team": 0,
   "lane": 0,
   "level": 1
  },
  {
   "x": 44,
   "y": 38,
   "team": 1,
   "lane": 0,
   "level": 1
  },
  {
   "x": 44,
   "y": 24,
   "team": 1,
   "lane": 0,
   "level": 1
  },
  {
   "x": 4,
   "y": 22,
   "team": 0,
   "lane": 1,
   "level": 1
  },
  {
   "x": 4,
   "y": 8,
   "team": 0,
   "lane": 1,
   "level": 1
  },
  {
   "x": 10,
   "y": 4,
   "team": 1,
   "lane": 1,
   "level": 1
  },
  {
   "x": 23,
   "y": 4,
   "team": 1,
   "lane": 1,
   "level": 1
  }
 ],
 "tiles": [
  "################################################",
  "#..............................................#",
  "#..............................................#",
  "#..............................................#",
  "#........................................P.P...#",
  "#..............................................#",
  "#......................................P.K.P...#",
  "#..............................................#",
  "#........................................P.....#",
  "#..............................................#",
  "#..............................................#",
  "#..............................................#",
  "#..............................................#",
  "#..............................................#",
  "#.............#..................#.............#",
  "#..............................................#",
  "#..............................................#",
  "#..............................................#",
  "#.......................#......................#",
  "#..............................................#",
  "#...................#.......#..................#",
  "#..............................................#",
  "#..............................................#",
  "#..............................................#",
  "#.................#.....S.....#................#",
  "#..............................................#",
  "#..............................................#",
  "#..............................................#",
  "#...................#.......#..................#",
  "#..............................................#",
  "#.......................#......................#",
  "#..............................................#",
  "#..............................................#",
  "#.............#..................#.............#",
  "#..............................................#",
  "#..............................................#",
  "#..............................................#",
  "#..............................................#",
  "#..............................................#",
  "#.....P.P......................................#",
  "#..............................................#",
  "#...P.K.P......................................#",
  "#..............................................#",
  "#.....P........................................#",
  "#..............................................#",
  "#..............................................#",
  "#..............................................#",
  "################################################"
 ]
}