{
  "name": "The Shattering",
  "expedition": true,
  "mode": "br",
  "objective": "Last operative standing — loot the shattered fields and outlive the closing zone",
  "time": 420,
  "br": {
    "shrinks": [
      {
        "at": 60,
        "r": 31.25
      },
      {
        "at": 150,
        "r": 20.42
      },
      {
        "at": 240,
        "r": 11.67
      },
      {
        "at": 330,
        "r": 5
      }
    ]
  },
  "chests": [
    {
      "loot": "medkit"
    },
    {
      "loot": "shards"
    },
    {
      "loot": "shards"
    },
    {
      "loot": "shards"
    },
    {
      "loot": "shield"
    },
    {
      "loot": "shards"
    },
    {
      "loot": "cracker"
    },
    {
      "loot": "cracker"
    },
    {
      "loot": "medkit"
    },
    {
      "loot": "token"
    },
    {
      "loot": "shield"
    },
    {
      "loot": "cracker"
    },
    {
      "loot": "shards"
    },
    {
      "loot": "medkit"
    },
    {
      "loot": "shards"
    },
    {
      "loot": "shards"
    },
    {
      "loot": "shards"
    },
    {
      "loot": "token"
    },
    {
      "loot": "shield"
    },
    {
      "loot": "cracker"
    },
    {
      "loot": "shards"
    },
    {
      "loot": "medkit"
    },
    {
      "loot": "shield"
    }
  ],
  "vehicles": [
    {
      "kind": "stag"
    },
    {
      "kind": "stag"
    },
    {
      "kind": "skiff"
    }
  ],
  "tiles": [
    "########################################################################",
    "#...................................,,,,,,,,,,,,,,,,,,,,,,,,,,,,,,,,,,,#",
    "#...................................,,,,,,,,,,,,,,,,,,,,,,,,,,,,,,,,,,,#",
    "#...................................P,,,,,,,,,,,,,,T,,TT,,,,,,,,,,,,,,,#",
    "#...P...............................,,,,,,T,,,,,,,,,TTT,T,,,,,,,,,,P,,,#",
    "#...................##..............,,,TTTTT,,,,,,,,TTT,,,,,,,,,,,,,,,,#",
    "#...................##..............,,,T,,,,T,,,,,,,T,T,,,,,,,,,,,,T,,,#",
    "#..............T....................,,,,,,T,,,,,,,,,,TT,,,,,,,,,,,T,T,,#",
    "#...........................C.......,,,T,TT,C,,,,,,,,,,,,,,,,,,,,,TT,,,#",
    "#.....##......T.....................,,,,,,,,,,,,,,,,,,,,,,,,,,,,,,,,,,,#",
    "#.....#.................Y...........,,,,,,,,,,,,,,,,,,,,,,,,,,,,,,,,,,,#",
    "#...................................,,,,,,,,,,,,,,,,,,,,,,,,,,,,,,,,,,,#",
    "#.......C...........................,,,,,,,,,,,,,,,,,,,T,T,TC,,,,,,,,,,#",
    "#...................................,,,,,,,,TT,,,,,,,,,TTTTT,,###,,,,,,#",
    "#...................................,,,,,,,,T,,,,,,,,TT,VT,T,,T,,,,,,,,#",
    "#....T..............................,,,,,,,,T,,,,,,,,T,,TT,T,,,,T,,,,,,#",
    "#....T..............................,,,,,,,,,,,,,,,,,,,,TTTTT,TTT,,,,,,#",
    "#...TT.........#....................,,,,,,,,,,,,,,,,,,,,,,T,,TTT,TT,,,,#",
    "#...................................,,,,,,,,,,,,,,,,,,,,,TT,,,,T#T,T,,,#",
    "#...........T##T....................,,,,,,,,,,,,,,,,,,,,,TT,,,,##,,,,,,#",
    "#...........TVTT....................,,,,,,,,,,,,,,,,,,,,,T,,,,,TT#,T,,,#",
    "#...........T.T.....................,,,,,,,,,,,,,,,,,,,,,,,,,,,,#T,,,,,#",
    "#...................................,,,,,,,,,,,,,,,,,,,,,,,,,,,T,,,,,,,#",
    "#...................................,,,,,,,,,,,,,,,,,,,,,,,,,,,,,,,,,,,#",
    "#.......................#...........,,,,,TT,,,,#,,C,,,,,,,,,,,,,,,,,,,,#",
    "#........................#...T......,,,TTTT,,,#,,,,TT,,,,,,,,,,,,,,,,,,#",
    "#.........T.........C.......T.T.....,,,,##TTT,,,,,T,T,,,,,,,,,Y,,,,,,,,#",
    "#.........TT...............T........,,T###TTTT,,,,TTTT,,,,,,,,,,,,,,,,,#",
    "#........T.......................#;;;;T##TT,T,,,,T,T,,,,,,,,,,,,,,,,,,,#",
    "#.......T....................#.;##;;;;###TTTT,,,,T,,T,,,,,,,,,,,,,,,,,,#",
    "#........T..C...............Y.;##;;;;;;###T,TT,,,,,,,,,,,,,,,,,,,,C,,,,#",
    "#........#...................##;;;;;S;;;;##,T,,,,,,,,,,,,,,,,,,,,,,,,,,#",
    "#........##..................##;;;;;C;;;;##,,T,,,,,,,,,,,,,,,,,,,,,,,,,#",
    "#...........................##;;;;;;;;;;;;##,,,,,,,,,,,,,,,,,,,,,,,,,,,#",
    "#...........................;;;;;;;;;;;;;;;;,,,,,,,,,,,,,,,,,,,,,,,,,,,#",
    "#...........................;;;;;C;##;;;;;;;,,,,,,,,,,,,,,,,,,,,,,,,,,,#",
    "#..P....;...........;;..;..;;;;;;;;##;C;;;;;________________________P__#",
    "#;;..;......;;..;.;.;..;....;;;;;;;;;;;;;;;;___________________________#",
    "#.;.;.;..;.;;.;;.;;.;;.;;;;.##;;;;;;;;;;;;##___________~~______________#",
    "#..;;;.;..;......;.;.....;;;.##;;;C;;;;C;##______________~_____________#",
    "#...;;.......;.;;..;##;##;#####;;;;;;;;;;##____________~~_~____________#",
    "#;..............;;..#;;;;;;;;;###;;;;;;###_________T_____~~____________#",
    "#.;;..##;#;;##;.;..oo;;;;;;;;#####;;;;###_#_Y__________________________#",
    "#.;;;;#;;;;;;;;...;.#;;;;;C;;;;;.#;;;;#___________________________~~~__#",
    "#..;.;#;;;;;;;#;.;;;#;;;;;;#;;#.;;..________#___________~_______C_~~~__#",
    "#;..;.#;;;;;;;#;;;.;#;;;;;;;;;#...;;____________________~________~~~___#",
    "#...;;;;;;C;;;;.;.;;#;;;;#;;;;;;..;;______T___#________~__~_____~~~~___#",
    "#;...;#;;;;;;;#..;;;#;#####;;;;;;...___________#_______~~_______T~_~___#",
    "#;.;..#;;;;;;;#..;;;.;;.;;;...;.;...____C_~______________~_______~~____#",
    "#;;;.;#;;;;;;;;;.;....;.......;;...;______~~__________~~~~~~~_____~____#",
    "#.;.;;##;####;#;.;.;;;;...;;;;..;;;._____~~~~_______~~~~~~~~~~~________#",
    "#;...;...;.;....;.;;....;.;..;..;;;;______________~~~~~~~~~~~~~~~______#",
    "#.;.;;;o....;;.;.;.;;;;...;..;;...;;_____~_~_____~~~~~~~~~~~~~~~~~_____#",
    "#;.....oo..;;;;.Y;..;;;.;..;....;..;____~________~~~_~~~~~~~~~~~~~_____#",
    "#;..;;.......;..;;....;.;;###;####;;__~_~~_____V~~~C__~~~~~~~~~~~~~____#",
    "#..;;.;;.....;..;.;...;;.#;;;;;;;#;;____~______________~~~~~~~~~~~~____#",
    "#.;.;.;...;##;#;#;##;..;.#;;;;;;;#.;____~_______~~~__C~~~~~~~~~~~~~____#",
    "#....;;..;#;;;;;;;;;#.;..;;;;;;;;#.;____________~~~~_~~~~~~~~~~~~~_____#",
    "#;...;.;;;;;;;;;;;;;;.;..#;;;C;;;;.._____________~~~~~~~~~~~~~~~~~_____#",
    "#;...;.;..#;;;;;;;;;;.;..#;;;;;;;#;;_____________T~~~~~~~~~~~~~~~______#",
    "#..;;;....#;;;C;;;;;;..;;;;;;;;;;#.._______________~~~~~~~~~~~~________#",
    "#;..;..;..#;;;;;;;;;;.;.;#;;;;;;;#;._________________~_~~~~~~__________#",
    "#.;;;.;;..#;;;;;;;;;;;...;#;#####;;.______Y____________________________#",
    "#.........#;;;;;;;oo#.;;..;.;;;...;;_____________________~_____________#",
    "#;;......;;###;#####;.;;o.;.;;......___________________T~~~____________#",
    "#;.;...;.;......;;......oooo...;;;.;_____________________~_____________#",
    "#.;..;;;.;;;;.;..;.;..;.;..;;;...;;.________C_________________C________#",
    "#.;.P.;..;;;...;...;...;.;....;;...._______________________________P___#",
    "#.;.;.;.;..;;;..;.;..;;.;...;;......P__________________________________#",
    "#..;;...;;;.;;;;..;..;..;..;;;;;;.;.___________________________________#",
    "#;...;;.;.;;....;;.....;;....;......___________________________________#",
    "########################################################################"
  ]
}
