{
  "name": "Broken Quorum",
  "objective": "Cross the shattered relay field — raise four pylons across the void and make the count true again",
  "time": 720,
  "story": true,
  "chapter": 3,
  "title": "Chapter III — Broken Quorum",
  "theme": "voidscar",
  "expedition": true,
  "intro": [
    {
      "title": "Chapter III — Broken Quorum",
      "lines": [
        "The relay field answered six of ten. Six is not a quorum.",
        "Where the pylons stood, the ground gave way — only the slabs still float.",
        "Cross the void. Raise four. Make the count true again."
      ],
      "art": "quorum"
    }
  ],
  "outro": [
    {
      "title": "Four of Four",
      "lines": [
        "The quorum holds. The relay field hums for the first time since the Fall.",
        "Keeper Vasht counts to ten now. All the way to ten. And smiles."
      ],
      "art": "quorum"
    }
  ],
  "captiveChars": [
    "shade",
    "warden"
  ],
  "modifiers": {
    "waves": [
      {
        "at": 240,
        "letters": "zzzaa",
        "edge": "e"
      },
      {
        "at": 480,
        "letters": "aann",
        "edge": "e"
      }
    ]
  },
  "npcs": [
    {
      "id": "keeper-vasht",
      "name": "Keeper Vasht",
      "lines": [
        "Six of ten... six of ten. The field answered six and the quorum wanted seven.",
        "I logged the fault at dusk. By dawn the void had eaten four pylons whole.",
        "I kept the count. I always keep the count. Counting is all the keeping I have left.",
        "The slabs drift. Mind the rim — a shot dies in the dark, and so does a careless step.",
        "Phantoms nest beyond the chasms. They walk through the rock as if it owed them nothing.",
        "Four fresh pylons, operator. All four. This Anchor takes no fractions."
      ],
      "gift": {
        "shards": 8
      }
    },
    {
      "id": "junie-marrow",
      "name": "Junie 'Hope' Marrow",
      "lines": [
        "Hope! Genuine bottled hope, friend — three shards a measure and worth every one.",
        "Crystal nodes on the slabs crack open at four shards apiece. Shoot them.",
        "The vault-wraiths snipe from the far rocks. Their bolts jump to whoever stands too close to you.",
        "Keep a slab between you and the void. The void keeps nothing it takes.",
        "When the gate lights, I cross first. That's not hope, friend — that's a plan."
      ]
    }
  ],
  "builds": [
    {
      "kind": "pylon",
      "cost": 12
    },
    {
      "kind": "barricade",
      "cost": 4
    },
    {
      "kind": "pylon",
      "cost": 12
    },
    {
      "kind": "turret",
      "cost": 10
    },
    {
      "kind": "barricade",
      "cost": 4
    },
    {
      "kind": "pylon",
      "cost": 12
    },
    {
      "kind": "pylon",
      "cost": 12
    },
    {
      "kind": "turret",
      "cost": 10
    }
  ],
  "gate": {
    "need": 4
  },
  "tiles": [
    "################################################################################",
    "#%%%%%%%%%%%%%%%%%%%%%%%%%%%%%%%%%%%%%%%%%%%%%%%%%%%%%%%%%%%%%%%%%%%%%%%%%%%%%%#",
    "#%%;;;;;;;;;;%%%%%%%%%%;;;;;;;;;;;%%%%%%%%%%%;;;;;;;;;;;;%%%%%%%%%%%%%%%%%%%%%%#",
    "#%%;;;;;;;;;;%%%%%%%%%%;;;;;;;;;;;%%%%%%%%%%%;;;;;;;;;;;;%%%%%%%%%%%%%%%%%%%%%%#",
    "#%%;;;;;;;;;;%%%%%%%%%%;;;;a;;;;;;%%%%%%%%%%%;;;;;;;;;;;;%%%%%%%%%%%%%%%%%%%%%%#",
    "#%%;;;P;;;;;;%%%%%%%%%%;;;;;;;;;;;%%%%%%%%%%%;;;;;B;By;;;%%%%%%%%%%%%%%%%%%%%%%#",
    "#%%;;;;;;N;;;%%%%%%%%%%;;;;;B;;B;;%%%%%%%%%%%;;;;;;;;;;;;%%%%%%%%%%%%%%%%%%%%%%#",
    "#%%;;P;;;;;;;%%%%%%%%%%;;;;;;;z;;;%%%%%%%%%%%;;;;;;;;;c;;%%%%%%%%%%%%%%%%%%%%%%#",
    "#%%;;;;;;;;;;//////////;;;;;;;;;;;%%%%%%%%%%%;;;;;;;;;;;;%%%%%%%%%%%%%%%%%%%%%%#",
    "#%%;;;;;;;;;;%%%%%%%%%%;;;;;;;;;;;%%%%%%%%%%%;;;;;;;;;;;;%%%%%%%%%%%%%%%%%%%%%%#",
    "#%%;;;Y;;;;;;%%%%%%%%%%;;;;;;;;;;;///////////;;;;;;;;;;;;%%%%%%%%%%%%%%%%%%%%%%#",
    "#%%;;;;;;;;;;%%%%%%%%%%;;k;;;;;;;;%%%%%%%%%%%;;;;Y;y;;;;;%%%%%%%%%%%%%%%%%%%%%%#",
    "#%%;;;;;;;;;;%%%%%%%%%%;;;;;;;;;;;%%%%%%%%%%%;;;;;;;;;;;;%%%%%%%%%%%%%%%%%%%%%%#",
    "#%%%%%%/%%%%%%%%%%%%%%%%%%%%%/%%%%%%%%%%%%%%%%%%%%/%%%%%%%%%%%%%%%%%%%%%%%%%%%%#",
    "#%%%%%%/%%%%%%%%%%%%%%%%%%%%%/%%%%%%%%%%%%%%%%%%%%/%%%%%%%%%%%%%%%%%%%%%%%%%%%%#",
    "#%%%%%%/%%%%%%%%%%%%%%%%%%%%%/%%%%%%%%%%%%%%%%%%%%/%%%%%%%%%%%%%%%%%%%%%%%%%%%%#",
    "#%%%%%%/%%%%%%%%%%%%%%%%%%%%%/%%%%%%%%%%%%%%%%%%%%/%%%%%%%%%%%%%%%%%%%%%%%%%%%%#",
    "#%%;;;;;;;;;;;%%%%%%%%%;;;;;;;;;;;;;%%%%%%%%%;;;;;;;;;;;;;%%%%%%%%%%%%%%%%%%%%%#",
    "#%%;;;;;;;;;;;%%%%%%%%%;;;;;;;;;;;;;%%%%%%%%%;;;;;;;;;;;;;%%%%%%%%%%%%%%%%%%%%%#",
    "#%%;;;;;;;;;;;%%%%%%%%%;;;;;;;;;;;;;%%%%%%%%%;;;;;;a;;;;;;%%%%%%%%%%%%%%%%%%%%%#",
    "#%%;;;;Y;;;;;;%%%%%%%%%;;;;;;;;;;;;;%%%%%%%%%;;;;;;;;;;;;;%%%%%%%%%%%%%%%%%%%%%#",
    "#%%;;;;;;;;;;;/////////;;;B;;B;;;;;;%%%%%%%%%;;;;;;;;;;;;;%%%%%%%%%%%%%%%%%%%%%#",
    "#%%;;;;;;;;;;;%%%%%%%%%;;;;;;;;;;;;;%%%%%%%%%;;;;;c;;;;;;;%%%%%%%%%%%%%%%%%%%%%#",
    "#%%;;;;;;;;;;;%%%%%%%%%;;;;;;;;;;k;;%%%%%%%%%;;;;;;;;;;;;;%%%%%%%%%%%%%%%%%%%%%#",
    "#%%;;;;;z;;;;;%%%%%%%%%;;;;;;;;;;;;;/////////;;;;;;;;;;;;;%%%%%%%%%%%%%%%%%%%%%#",
    "#%%;;;;;;;;;;;%%%%%%%%%;;;;;;;;;;;;;%%%%%%%%%;;;;;;;;;y;;;%%%%%%%%%%%%%%%%%%%%%#",
    "#%%;;;;;;;;;;;%%%%%%%%%;;;;;;;;;;;;;%%%%%%%%%;;;;;;;;;;;;;%%%%%%%%%%%%%%%%%%%%%#",
    "#%%%%%%%%%%%/%%%%%%%%%%%%%/%%%%%%%%%%%%%%%%%%%%%%%/%%%%%%%%%%%%%%%%%%%%%%%%%%%%#",
    "#%%%%%%%%%%%/%%%%%%%%%%%%%/%%%%%%%%%%%%%%%%%%%%%%%/%%%%%%%%%%%%%%%%%%%%%%%%%%%%#",
    "#%%%%%%%%%%%/%%%%%%%%%%%%%/%%%%%%%%%%%%%%%%%%%%%%%/%%%%%%%%%%%%%%%%%%%%%%%%%%%%#",
    "#%%;;;;;;;;;;;%%%%%%%%;;;;;;;;;;;;;%%%%%%%%%%;;;N;;;;;;;;;;%%%%%%%%%%%%%%%%%%%%#",
    "#%%;;;;;;;;;;;%%%%%%%%;;;;;;;;;;;;;%%%%%%%%%%;;;;;;;;;;;;;;%%%%%%%%%%%%%%%%%%%%#",
    "#%%;;;;;;;;;;;%%%%%%%%;;;;;;;;;;;;;%%%%%%%%%%;;;;;a;;;;;;;;%%%%%%%%%%%%%%%%%%%%#",
    "#%%;;;;Y;;;;;;%%%%%%%%;;;;a;;;;;;;;%%%%%%%%%%;;;;;;;;Y;;;;;%%%%%%%%%%%%%%%%%%%%#",
    "#%%;;;;;;;;;;;////////;;;;;;B;;B;;;%%%%%%%%%%;;;;;;;;;;;;;;%%%%%%%%%%%%%%%%%%%%#",
    "#%%;;;;;;;;;;;%%%%%%%%;;;;;;;;;;;;;%%%%%%%%%%;;;;;;;;;;;;;;%%%%%%%%%;;;;;;;;%%%#",
    "#%%;;;;;;;;;;;%%%%%%%%;;;;;;;;zk;;;%%%%%%%%%%;;;;;;;;;;;;;;/////////;;;;;;;;%%%#",
    "#%%;;;;;;;;;;;%%%%%%%%;;;;;;;;;;;;;%%%%%%%%%%;;;;;y;;;;;;;;%%%%%%%%%;;;;EE;;%%%#",
    "#%%;;;;;;;;;;;%%%%%%%%;;;;;;;;;;;;;//////////;;;;;;;;;;;;;;%%%%%%%%%;;;;EE;;%%%#",
    "#%%;;;;;;;;;;;%%%%%%%%;;;;;;;;;;;;;%%%%%%%%%%;;;;;;;;;;;;;;%%%%%%%%%;;;;;;;;%%%#",
    "#%%%%%%%%%%%%%%%%%%%%%%%%%%%%%%%%%%%%%%%%%%%%%%%%%%%%%%%%%%%%%%%%%%%%%%%%%%%%%%#",
    "#%%%%%%%%%%%%%%%%%%%%%%%%%%%%%%%%%%%%%%%%%%%%%%%%%%%%%%%%%%%%%%%%%%%%%%%%%%%%%%#",
    "#%%%%%%%%%%%%%%%%%%%%%%%%%%%%%%%%%%%%%%%%%%%%%%%%%%%%%%%%%%%%%%%%%%%%%%%%%%%%%%#",
    "################################################################################"
  ]
}
