{
  "name": "Forkfall",
  "title": "Chapter IV — Forkfall",
  "objective": "Cross the glitch seam into the false twin city — raise three pylons to settle the fork",
  "time": 700,
  "story": true,
  "chapter": 4,
  "expedition": true,
  "intro": [
    {
      "title": "Forkfall",
      "lines": [
        "The timeline forked here. Seal the false branch.",
        "A whole city, copied street for street across the scar.",
        "Three pylons. One city gets to be real."
      ],
      "art": "forkfall"
    }
  ],
  "modifiers": {
    "waves": [
      {
        "at": 300,
        "letters": "wwwww",
        "edge": "w"
      },
      {
        "at": 480,
        "letters": "wwgg",
        "edge": "e"
      }
    ]
  },
  "outro": [
    {
      "title": "One City",
      "lines": [
        "The false branch thins to static and is gone. One city. One history.",
        "On the far bank, Mirra Vex waves goodbye. Once."
      ],
      "art": "forkfall"
    }
  ],
  "captiveChars": [
    "boomer",
    "helix"
  ],
  "npcs": [
    {
      "id": "mirra-vex-west",
      "name": "Mirra Vex",
      "lines": [
        "You walked in from the west. Good. That means you're the real one.",
        "There is a me across the seam. There was never a me across the seam.",
        "Forklings boil out of the scar in waves — get the barricades up on the cross-streets before the next one.",
        "Three pylons, one quorum. The Anchor settles, and one of these cities stops having happened.",
        "If she offers you shards — take them. They spend real."
      ]
    },
    {
      "id": "mirra-vex-east",
      "name": "Mirra Vex",
      "lines": [
        "You walked in from the east. Good. That means you're the real one.",
        "There is a me across the seam. There was never a me across the seam.",
        "Take these. Shards, pulled out of the scar. They spend real.",
        "The nests glow in the old courtyards — crack the spawners between pulses or the streets never empty.",
        "If she told you to trust me — she would never say that."
      ],
      "gift": {
        "shards": 6
      }
    }
  ],
  "builds": [
    {
      "kind": "barricade",
      "cost": 4
    },
    {
      "kind": "barricade",
      "cost": 4
    },
    {
      "kind": "pylon",
      "cost": 13
    },
    {
      "kind": "pylon",
      "cost": 13
    },
    {
      "kind": "pylon",
      "cost": 13
    },
    {
      "kind": "turret",
      "cost": 10
    },
    {
      "kind": "barricade",
      "cost": 4
    }
  ],
  "gate": {
    "need": 3
  },
  "tiles": [
    "####################################################################################",
    "#;;;;;_;__;;;;;;;;;;;;;;;;;;;;;;;;;;;;;;;__;;;;;;;;;;;;;;;;;;;;;;;;;;;;;;;__;_;;;;;#",
    "#;;;;;######;;;###_##;;;######;;;;;;_;;;;__;;;;_;;;;;;######;;;##_###;;;######;;;;;#",
    "#;;;;;###_T#;;;#;##;#;;;##T###;;;;;;###;;__;;###;;;;;;###T##;;;#;##;#;;;#T_###;;;;;#",
    "#;;;;;####_#;;;######;;;TT####;;;;;;#;;;;;;;;;;#;;;;;;####TT;;;######;;;#_####;;;;;#",
    "#;;;;;###_#_c;;####;#;;;######;;;;;;#;_;;__;;_;#;;;;;;######;;;#;####;;;_#_###;;;;;#",
    "#;;;;;###;##;_;#T####;;;######;;;_#;_;_;;#;;;_;_;#_;;;######;;;####T#;_;##;###;;;;;#",
    "#;;;;;T####T;_T######;;;T#####;;;;;;_#_;;__;;_#_;;;;;;#####T;;;######T_;T####T;;;;;#",
    "#;;;;;;###_T_;;T#_###;;;######;;;;#;;;;;;__;;;;;;#;;;;######;;;###_#T;;_T_###;;;;;;#",
    "#;;;;;;;;;____;;;;_;;;;;;;;;;;;;;;;;;;;;Y;;;;;;;;;;;;;;;;;;;;;;;;_;;;;____;;;;;;;;;#",
    "#;;;;;;;___;;;;;;_;;;;;;;;;;;;;;;;;;;_;_;__;_;_;;;;;;;;;;;g;;;;;;;_;;;;;;___;;;;;;;#",
    "#;;T;;;;____;;;;;;;;;;;__;g;;;;;;;;;;___;__;___;;;;;;;;;;;;__;;;;;;;;;;;____;;;;T;;#",
    "#;;;;;######;;;######;_;##;###;;;T#####;;__;;#####T;;;###;##;_;######;;;######;;;;;#",
    "#;;;;;######;;;#;;;;#___####;#;;;######;;__;;######;;;#;####___#;;;;#;;;######;;;;;#",
    "#;;;;;##_##T;;;#;;;;#__;##T###;;;#_####;;__;;####_#;;;###T##;__#;;;;#;;;T##_##;;;;;#",
    "#;;;;;###_##;;;;;;m;#___###T##;;;#T####_;__;_####T#;;;##T###___#;m;;;;;;##_###;;;;;#",
    "#;;;;;######;;;;;;;;#;;;#;####T;;T#####;____;#####T;;T####;#;w;#;;;;;;;;######;;;;;#",
    "#;;;;;######;;;#;;;;#;;;######;;;####;#_;_#;_#;####;;;######;;;#;;g;#;;;######;;;;;#",
    "#;;;;;#T####;;;#;;;;#;;;######;;;###__#_;__;_#__###;;;######;;;#;;;;#;;;####T#;;;;;#",
    "#;;;;;##T##T;;;######;;;#####_;;;###_##______##_###;;;_#####;;;######;;;T##T##;;;;;#",
    "#;;;;;;__;__;;;;;;;;;;;_____;;;;T;;;;;;;w;;;;;;g;;;T;;;;_____;;;;;;;;;;;__;__;;;;;;#",
    "#;;;;;;_;_;;;;;;;;;;;;;_;_;_;;;;;;o;o;;;;__;;;;;;;;;;;;;_;_;_B;;;;;;;;;;;;_;_;;;;;;#",
    "#;;;;;;___;_;B;;;;;;;;;_;;__;;;;;;;n;;;;;__;;;;;;;;;;;;;__;;_;;;;;;;;;;;_;___;;;;;;#",
    "#;;;;;#__###;;;T###T#;;;###;##;;;###o#T;;__;wT#;###;;;##;###;;;#T###T;;;###__#;;;;;#",
    "#;;;;;#####_;;;######;;;#T###;;;;####T#;;__;;#T####;;;;###T#;;;######;;;_#####;;;;;#",
    "#;;;;;####T#;;;######;;;##T#_#;;;######;;__;;######;;;#_#T##;;;######;;;#T####;;;;;#",
    "#;;;;;##_#;#;;;_##T##;;;#;####;;;####;#;;__;;#;####;;;####;#;;;##T##_;;;#;#_;;;;;;;#",
    "#;;;;;######;;;#####;;;;######;;;;#__##;;;;;;##__#;;;;######;;g;#####;;;####;;;;;;;#",
    "#;;;;;Y;;;g#;;;T##T##;;r####;#;;;T;####;;__;;####;T;;;#;####;;;##T##T;;;;Y##;;;;;;;#",
    "#;;;;;;#####;;;######;;;######;;;#_####;;__;;####_#;r;######;;;######;;;####;;;;;;;#",
    "#;;P;P;;;;;;;;;;;;;;;;Y;;;;;r;;;_;;Y_;;;;__;;;;_;;;_;;;;;Y;;;;;;;;;;;;;;;;;;;;;;;;;#",
    "#;;;;;;;;;;;;;;;;;B;;;;;;;;;;;;;_;_;;;;;;__;;;;;;_;_;;;;;;;;;;;;;;;;;;B;;;;;;;;;EE;#",
    "#;;;;;;;;_;_;;;;;;;;;;;;;;;;;;;;_;____;w;__B;;____Y_;;;;;;;;;;;;;;;;;;;;_;_;;;;;EE;#",
    "#;;P;P;;;;;_;;;;;;;;;;;;;;;;;;;;;______;;;;;w______;;;;;;;*;;;;Yr;;;;;;;_B;;;;;;;;;#",
    "#;;;;;;####_;;Y#_####N*;###_##Y;;######;;__;;######;;;##_###N;;####_#;;;_###;;;;;;;#",
    "#;;;;;;###T;;;;#T####;T;###_#_;;;T#T###;;__;;###T#T;;;_#_###;T;####T#;;;;T##;;;;;;;#",
    "#;;_;;#_####;;;#####;;;;##;###r_;#####T;;;;;;T#####;_;###;##;;;;#####;;;####;;;;;;;#",
    "#;;_;_######;;;T#####;;;######;_;####_#;;__;;#_####;_;######;;r#####T;;;####;;;;;;;#",
    "#;;___#;####;;;######;;;######__;##_###;;#_;w###_##g__######;;;######;;;####;;;;;;;#",
    "#;;;;;_;####;;;###;##;;;######;_;#T##;#;;__;;#;##T#;_;######;;;;;w###;;;####;_;;;;;#",
    "#;;;;;######;;;;;####;;;####_#_;;###_##;;;;;;##_###;;_#_####;;;####;;;;;######;;;;;#",
    "#;;;;;;;;;;;;;;_;_;;;;;;;;;;;;;;;;;;;;;;;__;;;;o;o;;;;;;;;;;;;;;;;_;_;;;;;;;;;;;;;;#",
    "#;;;;;;;;;;;;;;__;;;;;;;;;;;;;;;;;;;;;;;;__w;;;;n;;;B;;;;;;;;;;;;;;__;;;;;;;;;;;;;;#",
    "#;;;;;;;;_;___;__;__;;;;;;;;;;;;;;;;;;;;;__;;w;o;o;;;;;;;;;;;;;;__;__;___w_;;;;;;;;#",
    "#;;;;;#T####__;#####_;;;######;;;;#_;;;;;__;;;;;_#;;;;######;;;_#####;__####T#;;;;;#",
    "#;;;;;###_##;_;;#####;;;#;;;;#;;;;;#;;;;;__;;;;;#;;;;;#;;;;#;;;#####;;_;##_###;;;;;#",
    "#;;;;;######;_;#T####;;;#;;;;#;;;#####;;;;;;;;#####;;;#;;;;#;;;####T#;_;######;;;;;#",
    "#;;;;;######_;;######;;;#;m;;#;;;;;;_;#;;;;;;#;_;;;;;;#;;m;#;;;######;;_######;;;;;#",
    "#;;;_;#####;;;;#;####;;;#;;;;#;;;#;_;;;;w__;;;;;_;#;;;#;;;;#;;;####;#;;;w#####;_;;;#",
    "#;____######;;;T#####___#_;;;#;;;;##;#_;;__;;_#;##;;;;#;;;_#___#####T;;;######____;#",
    "#;__;_######;;g###T##_;;#_;;;#_;;_T;;;;;;__;;;;;;T_;;_#;;;_#;;_##T###;;;######_;__;#",
    "#;___;;#####;;;##;###;__##;;##;;;;;;#;;;;;;;;;;#;;;;;;##;;##__;###;##;;;#####;;___;#",
    "#;;;;;_;;;;;;;;;;;;;;;_;;_;;_;_;;;;;g;;;;__;;;;;;;;;;_;_;;_;w_;;;;;;;;;;;;;;;_;;;;;#",
    "#;;;T;;;;;;;g;;;;;;;;__;_;;;;;;;;;;;;;;;;__;;;;;;;;;;;;;;;;_;__;;;;;;;;;;;;;;;;T;;;#",
    "#;;;;;;;;;;__;;;;;;;;;;;;;;;;;;;;;;;;;;;;;Y;;;;;;;;;;;;;;;;;;;;;;;;;;;;__;;;;;;;;;;#",
    "#;;;;;;;;;##__;######;;;#;####;;;T#####;;__;;#####T;;;####;#w;;######;__##;;;;;;;;;#",
    "#;;;;;;;#;##__T##;###;;;T#_###;;;######;;__;;######;;;###_#T;;;###;##T__##;#;;;;;;;#",
    "#;;;;;#;;_;_T;;###T#T;;;######;;;##;###;;_#;;###;##;;;######;;;T#T###;cT_;_;;#;;;;;#",
    "#;;;;;#;#;__;;;##_###;;;##_#;;;;;#;####;;__;;####;#;;;;;#_##;;;###_##;;;__;#;#;;;;;#",
    "#;;;;;;#;#__;;;###T##;;;###;##;;;######;;;;;;######;;;##;###;;;##T###;;;__#;#;;;;;;#",
    "#;;;;;;;;#;;;;;#_####;;;##_###;;;#T_###;;;;;;###_T#;;;###_##;;;####_#;;;;;#;;;;;;;;#",
    "#;T;;;##;;;_;;;######;;;_#T###;;;######;;__;;######;;;###T#_;;;######;;;_;;;##;;;T;#",
    "#;;;;;;;;;;;;;;;;;;;;;;;;T;;;;;;;;;;;;;;;__;;;;;;;;;;;;;;;T;;;;;;;;;;;;;;;;;;;;;;;;#",
    "####################################################################################"
  ]
}
