{
  "name": "Cluster Siege",
  "story": true,
  "chapter": 5,
  "title": "Chapter V — Cluster Siege",
  "objective": "Hold the cluster camp through the nightwaves — sortie out to raise all three pylons and wake the Anchor in the east bastion",
  "time": 720,
  "expedition": true,
  "intro": [
    {
      "title": "The Long Night",
      "lines": [
        "The cluster camp douses its lights. The Entropy masses in the trees.",
        "Three relay pylons stand cold in the dark — north, west, south.",
        "Hold the walls. Sortie between waves. Keep the signal alive."
      ],
      "art": "siege"
    }
  ],
  "modifiers": {
    "dark": true,
    "waves": [
      {
        "at": 120,
        "letters": "ggggww",
        "edge": "n"
      },
      {
        "at": 280,
        "letters": "rrggww",
        "edge": "w"
      },
      {
        "at": 440,
        "letters": "ssggwww",
        "edge": "s"
      },
      {
        "at": 580,
        "letters": "rrssggg",
        "edge": "e"
      }
    ]
  },
  "outro": [
    {
      "title": "Dawn Over the Camp",
      "lines": [
        "The last nightwave breaks against the walls and does not come again.",
        "Three relays burn steady. The warden finally sits down.",
        "One road left: east, to the Settlement."
      ],
      "art": "dawn"
    }
  ],
  "captiveChars": [
    "bastion"
  ],
  "npcs": [
    {
      "id": "warden-okafor",
      "name": "Warden Okafor",
      "lines": [
        "Nightwave's close — walls up, lights low.",
        "In this dark they see eight tiles, no further. Stay dim, strike first.",
        "Five gaps in my wall, five barricade frames waiting. Do the arithmetic before the north wave does.",
        "The pylons sit out in the black — north, west, south. Sortie between waves, never during.",
        "Take my reserve, ten shards. Mortar for the gaps or light for the gate. Spend it alive."
      ],
      "gift": {
        "shards": 10
      }
    },
    {
      "id": "doc-aroyo",
      "name": "Doc Aroyo",
      "lines": [
        "You again! Last needle I put in you was at the Crossing keep. Small frontier.",
        "Hm, hm-hmm... the old transit jingle. Pre-Fall. It keeps my hands steady.",
        "Crystal nodes glow along the roads — four shards a node. Crack them before the waves trample through.",
        "Stay by the fires between sorties. This dark gets into the joints.",
        "When the Anchor settles, the lines run again. I'll hum us the whole way home."
      ]
    }
  ],
  "builds": [
    {
      "kind": "pylon",
      "cost": 12
    },
    {
      "kind": "barricade",
      "cost": 4
    },
    {
      "kind": "pylon",
      "cost": 12
    },
    {
      "kind": "turret",
      "cost": 10
    },
    {
      "kind": "barricade",
      "cost": 4
    },
    {
      "kind": "barricade",
      "cost": 4
    },
    {
      "kind": "barricade",
      "cost": 4
    },
    {
      "kind": "turret",
      "cost": 10
    },
    {
      "kind": "barricade",
      "cost": 4
    },
    {
      "kind": "pylon",
      "cost": 12
    }
  ],
  "gate": {
    "need": 3,
    "after": 600
  },
  "tiles": [
    "########################################################################",
    "#,,,,,,,,,,,,,,,,,,,,,,,,..,,,,,,,,,,,,,,,,,,,,,,,,,,,,,,,,,,,,,,,,,,,,#",
    "#,,,,,,,,,,,,,,,,,,,,,,,,..,,,,,,T,,,,,#T,,T,,,,,,,,,,,,,,,,,,,,,,,,,,,#",
    "#,,,,,,,,,,,,,,,,,,,,,,,,..,,,T#,TT,,,,TTTT,,,,,,,,,,,,,,,,,,,,,,,,,,,,#",
    "#,,,,,,,,,,,,,,,,,,,,,,,,..,,,,,#,#,,,,,,,T,,,,,,,,,,,,,,,,,,,,,,,,,,,,#",
    "#,,,,TT,T,,,,,,,,,,,,,,,,..,,,TTT#TT,,,,TTT,,,,,,,,,,,,,,,,,,,,,,,,,,,,#",
    "#,,,,T#T#,,,,,,,,g,,,,,,,..,Y,,TT,,,,,,,#,T,,,:,,,,,,,,,,,,,,,,,,,,,,,,#",
    "#,,,,TTT,,,,,,,,,,,,,,,,,..,,,,,T#T,,,,,,T,,,:~:,,,,,,,,,,g,,,,,,,,,,,,#",
    "#,,,,,TT,,,,,,,,,,,,,,,,,..,B,,T,,#T,,,,T,g,,:~~:,,,,,,,,,,,,,,,,,,T,,,#",
    "#,,,,,,,,,gg::,,,,,,,,,,,..,,,,,,TT,,,,,,,,,,,::,,,,,,,,g,,,,,,,,TTT#,,#",
    "#,,,,,,,,:~~~~:,,,,,,,,,,..,,,,,T,,,,,,,,,,,,g,,g,,,,,,,,,,,,,,,TTT,T,,#",
    "#,,,,,,,,,::~::,,,,,,,,,,..,,,,,,#,,,,,,,,,,,,,,,,,,,,,,,,,,,,,TTTT,T,,#",
    "#,,,,g,,,,,::~~:,,,,,,,,,a.,,,,,,,,,,,,,,,,,,,,,,,,,,,,,,,,,,,,,#,#T,T,#",
    "#,,,,,,,,,T~:::,,,,,,,,,Y..,,,,,,,,,,,,,g,,,,,,,,,,,,,,,,,,,,,,TT,,,,T,#",
    "#,,,,,,,,,#:#..#.........................,,,,,,,,,,,,,,,,,,,,,,,,,T,,,,#",
    "#,,,,,,,,TTT#..#T.......T.............g..,,,,,,,,,,,,,,,,,,,,,,TT#,,,,,#",
    "#,,,,,,,,T#T..#T.T......T................,,,,,,,,,,,,,,,a,,,,,,T,,,,,,,#",
    "#,,,,,,,,#TT..##T......##......Y.........,,,,,,T,,,,,,,,,,,,,T,,T,,,,,,#",
    "#,,,,,,,,,TT............T..T.............,,,,,,T,,,,,,,,,,,,,,T,T,,,,,,#",
    "#,,,,,,,,T,T#T...TT...TT#..#.............,,,,,,T,,,,,,,,,,,,,,,TT,,,,,,#",
    "#,,,,,,,T#TT##....########B########......,,,,,,,,,,,,,,,,,,,,,T,,,,,,,,#",
    "#,,,,,,,,#,T#.....#;;;;;;;;;;;;;;;#......,,,,,,,,,,,,,,,,,,,,,,,,,,,,,,#",
    "#,,,,,,,,,T,......#;;;;;;;N*;;;;;;#......,,,,,,,,,,,#############,,,,,,#",
    "#,,,,,,,,,,,......#;;;;;;;;;;;;;;;#......,,,,,,,,,,,#;;;;;;;;;;;#,,,,,,#",
    "#,,,,,,,,,,,......#;;;;;;;;;;;;;;;#......,,,,,,,,,,,#;;n;;;;;;;;#,,,,,,#",
    "#,,,,,,B,a,,......#;;B;;;;;;;;;;;;#......,,,,,,,,,o,#;;;;;;;;;;;#,,,,,,#",
    "#,,,,,,,,,T,..TT..#;;;;;;;;;;;;;;;#___Y_a___________#;;;;;;;;;;;#,,,,,,#",
    "#..........Y......#;;;;;P;;;P;;;;;B______________Y__;;;;;;;;EE;;#,,,,,,#",
    "#.................B;;;;;;;*;;;;;;;B_________________;;;;c;;;EE;;#,,,,,,#",
    "#,,,,,,T#,TT......#;;;;;P;;;P;;;;;#_________Y__a____#;;;;;;;;;;;#,,,,,,#",
    "#,,,,Y,,#,T#......#;;;;;;;;;;;;;;;#......,,,,,,,,,o,#;;;;;;;;;;;#,,,,,,#",
    "#,,,,,,,,#,,......#;;;;;;;;;;;;B;;#......,,,,,,,,,,,#;;n;;;;;;;;#,,,,,,#",
    "#,,,,,,T,,,,......#;;;;;;;;;;;;;;;#......,,,,,,,,,,,#;;;;;;;;;;;#,,,,,,#",
    "#,,,,,,,,T,,......#;;;;;;;;;;;;;;;#......,,,,,,,,,,,#;;;;;;;;;;;#,,,,,,#",
    "#,,,,,,,T,,,......#;;;;;;;N*;;;;;;#......,,,,,,,,,,,#############,,,,,,#",
    "#,,,,,TT#T,,......#;;;;;;;;;;;;;;;#......,,,,,,,,,,,,,,,,,,,,,,,,,,,,,,#",
    "#,,,,,,#,TT,......########B########......,,,,,,,,,,,,,,,,,,,,,,,,,,,,,,#",
    "#,,,,,,,T,,,..g..........................,,,,,,,,,,,,,,,,,,,,,,,,,,,,,,#",
    "#,,,,,,,,,T,.............................,,,,,,,,,,,,,,,,,,,,,,,,,,,,,,#",
    "#,,,,,#,,,,,.............................,,,,,,,,,,,,,,,,,,,,,,,,,,,,,,#",
    "#,,,,,,T,T,,.............................,,,,,,,,,,,,,,,a,,,,TTT,,,,,,,#",
    "#,,,,,TT,,,,.............................,,,,,,,,,,,,,,,,,,,T#,,,,,,,,,#",
    "#,,,,,T,T,,g:......#.....................,,,,,,,,,,,,,,,,,,,,,TTT,,,,,,#",
    "#,,,,T,,,:::~:,,,,,,TTT,Y..,,,,,,,,,,,,T,,,,,,T,,,,,,,,,,,:,T,,TT,,,,,,#",
    "#,,,,TT,:~~~:~:,,,,,,,,,,a.,,,,,,,,,,,,#TTT,,,T#g,,,,,,,,:~:TT,TT,,,,,,#",
    "#,,,,,,,,::~~:,,,,,g,,,,T..,,,,,,,,,,,,TTTT#,T,T,,,,,,,,,:~~~T,T,,,,,,,#",
    "#,,,,,,,,:~~:,,,,,,,,,,T,..,,,,,,,,,,T,,##,,#,,,,,,,,,,,:~:~:~:,,,,,,,,#",
    "#,,,,,,,,:~~:,,,,,,,T,,,T..,,,,,,,,,,,,,TT#,,,,,,,,,,,,,:~:~~~:,,,,,,,,#",
    "#,,#T,#,,,::,,,,,,,,,,,,,..,B,,,,,,,,,T#T,#,,,,,,,,,,,,,,:,:~:,,,,,,,,,#",
    "#,,,,,,T,,,,,,,,,,,,,,,,,..,,,,,,,,,,,T,T,T,,,,,,,,,,,,,,,,,:,,,,,,,,,,#",
    "#,,,,T,,,,,,,,,,,,,,,,,,,..,,,,,,,,,,,,,T,,,,,,,,,,,,,,,,,,,,,,,,,,,,,,#",
    "#,,,,,,,,,,,,,,,,,,,,,,,,..,Y,,,,,,,,T,T#,,,,,,,,,,,,,g,,,,,,,,,,,,,,,,#",
    "#,,,,,,,,,,,,,,,,,,,,,,,,..,,,,,,,,,,T,#,T,,,,,,,,,,,,,,,,,,,,,,,,,,,,,#",
    "#,,,,,,,,,,,,,,,,,,,,,,,,..,,,,,,,,,,,#T,,,,,,,,,,,,,,,,,,,,,,,,,,,,,,,#",
    "#,,,,,,,,,,,,,,,,,,,,,,,,..,,,,,,,,,,,,,,,,,,,,,,,,,,,,,,,,,,,,,,,,,,,,#",
    "########################################################################"
  ]
}
