{
  "name": "Grand Relays",
  "title": "Versus — Grand Relays",
  "objective": "Ridge, field or canal — run the enemy banner home; first to 3 captures takes the day",
  "time": 480,
  "mode": "ctf",
  "expedition": true,
  "captiveChars": [],
  "chests": [
    {
      "loot": "cracker",
      "amount": 2
    },
    {
      "loot": "cracker",
      "amount": 2
    },
    {
      "loot": "shield",
      "amount": 1
    },
    {
      "loot": "shards",
      "amount": 8
    },
    {
      "loot": "shards",
      "amount": 8
    },
    {
      "loot": "shield",
      "amount": 1
    },
    {
      "loot": "shards",
      "amount": 10
    },
    {
      "loot": "shards",
      "amount": 10
    }
  ],
  "vehicles": [
    {
      "kind": "stag"
    },
    {
      "kind": "stag"
    },
    {
      "kind": "stag"
    },
    {
      "kind": "stag"
    },
    {
      "kind": "skiff"
    },
    {
      "kind": "skiff"
    },
    {
      "kind": "skiff"
    },
    {
      "kind": "skiff"
    }
  ],
  "builds": [
    {
      "kind": "turret",
      "cost": 10
    },
    {
      "kind": "turret",
      "cost": 10
    },
    {
      "kind": "turret",
      "cost": 10
    },
    {
      "kind": "turret",
      "cost": 10
    }
  ],
  "tiles": [
    "########################################################################################################################",
    "########################################################################################################################",
    "##.##T#####TT.###T.###T####.###.T.T####T###..#############.TT.#############..###T####T.T.###.####T###.T###.TT#####T##.##",
    "##..#.T##......##..T##..##T.###....T....#.#....#######.###....###.#######....#.#....T....###.T##..##T..##......##T.#..##",
    "##..T...........T............##.........T......##.T.TT.TTT....TTT.TT.T.##......T.........##............T...........T..##",
    "###........................_.##................##......................##................##._........................###",
    "##......._...................##................##.._................_..##................##..................._.......##",
    "###....T........_............##............._..##o.._....._.._....._..o##.._.............##............_........T....###",
    "##..................._.......##..........................................................##......._...................##",
    "##...........................##..........................................................##...........................##",
    "###..........................##................##o....................o##................##..........................###",
    "##....._.....................##o...............##......................##...............o##....................._.....##",
    "###...............................C............##......................##............C...............................###",
    "##.............................................##.T..................T.##.............................................##",
    "###..........T........T......##o...............##......................##...............o##......T........T..........###",
    "###.......;;;................##................##......................##................##................;;;.......###",
    "###.......;;;T....T..........##.........._.__..##......................##..__._..........##..........T....T;;;.......###",
    "##..T.....;;;...............T##................##...Y..............Y...##................##T...............;;;.....T..##",
    "##.....T..;;;T....TT....T....##................##......................##................##....T....TT....T;;;..T.....##",
    "###.......;;;................##................##......................##................##................;;;.......###",
    "##........;;;.............T..##................##......_...TT..._......##................##..T.............;;;........##",
    "##########;;;#######################...##################;;;;;;##################...#######################;;;##########",
    "##........;;;.....#.#.#........#.........................;;;;;;.........................#........#.#.#.....;;;........##",
    "###.......;;;.........T.T.........................._.....;;;;;;....._..........................T.T.........;;;.......###",
    "##........;;;............T.............................._;;;;;;_..............................T............;;;........##",
    "####......;;;....#..._...................................;;;;;;..................................._...#....;;;......####",
    "##########;;;########.........................._.._......;;;;;;......_.._..........................########;;;##########",
    "##;;;;;;;;;;;;;;;;;;#.....T.##_...............Y..........;;;;;;..........Y..............._##.T.....#;;;;;;;;;;;;;;;;;;##",
    "##;;;;;;;;;;;;;;;;;;#.......##....................._.....;;;;;;....._.....................##.......#;;;;;;;;;;;;;;;;;;##",
    "##;;;;S;;;;;;;;;;;;;#.T........_....T....................;;;;;;....................T...._........T.#;;;;;;;;;;;;;S;;;;##",
    "##;;;;;;;;;;;;;;;;;;#...................T..T##...........;;;;;;...........##T..T...................#;;;;;;;;;;;;;;;;;;##",
    "##;;;;;;;;;;;;;;;;B;#......._...............##...._.......;;;;......._....##..............._.......#;B;;;;;;;;;;;;;;;;##",
    "##;;;;;;;;;;;;;;;;;;#.o..........TT.....................#;;;;;;#.....................TT..........o.#;;;;;;;;;;;;;;;;;;##",
    "##;;P;;;;;;;;;;;;;;;#..o...........T...............oo..;;;;;;;;;;..oo...............T...........o..#;;;;;;;;;;;;;;;P;;##",
    "##;;;;;;;;;;;;;;;;;;.......T..._....._................Y;;;;;;;;;;Y................_....._...T.......;;;;;;;;;;;;;;;;;;##",
    "##;;P;;;;;;;;;;;;;;;;;;;;;;;;;;;;;;;;;;;;;;;;;;;;;;;;;;;;;;;;;;;;;;;;;;;;;;;;;;;;;;;;;;;;;;;;;;;;;;;;;;;;;;;;;;;;;;P;;##",
    "##;;;;;;;D;;;;;;;;;;;;;;;;;;;;;;;;;;;;;;C;;;;;;;;;;;;;;;C;;;;;;C;;;;;;;;;;;;;;;C;;;;;;;;;;;;;;;;;;;;;;;;;;;;;;D;;;;;;;##",
    "##;;P;;;;;;;;;;;;;;;;;;;;;;;;;;;;;;;;;;;;;;;;;;;;;;;;;;;;;;;;;;;;;;;;;;;;;;;;;;;;;;;;;;;;;;;;;;;;;;;;;;;;;;;;;;;;;;P;;##",
    "##;;;;;;;;;;;;;;;;;;......._.._..........._...........Y;;;;;;;;;;Y..........._..........._.._.......;;;;;;;;;;;;;;;;;;##",
    "##;;P;;;;;;;;;;;;;;;#_.o.T.........T.....T.........oo..;;;;;;;;;;..oo.........T.....T.........T.o._#;;;;;;;;;;;;;;;P;;##",
    "##;;;;;;;;;;;;;;;;;;#.o........._TT...........T.....T..;;;;;;;;;;..T.....T...........TT_.........o.#;;;;;;;;;;;;;;;;;;##",
    "##;;;;;;;;;;;;;;;;B;#T......._...........T..##..........#;;;;;;#..........##..T..........._.......T#;B;;;;;;;;;;;;;;;;##",
    "##;;;;;;;;;;;;;;;;;;#.......................##.._.........;;;;........._..##.......................#;;;;;;;;;;;;;;;;;;##",
    "##;;;;V;;;;;V;;;;;;;#..._...._......................._...;;;;;;..._......................._...._...#;;;;;;;V;;;;;V;;;;##",
    "##;;;o;o;;;o;o;;;;;;#......_##...._......................;;;;;;......................_....##_......#;;;;;;o;o;;;o;o;;;##",
    "##;;;;;;;;;;;;;;;;;;#.......##.._.............Y..........;;;;;;..........Y............._..##.......#;;;;;;;;;;;;;;;;;;##",
    "##;;;;;;;;;;;;;;;;;;#...T........_.......................;;;;;;......................._........T...#;;;;;;;;;;;;;;;;;;##",
    "##########;;;########.........................T...._.T...;;;;;;...T._....T.........................########;;;##########",
    "##.#......;;;....#.......................................;;;;;;.......................................#....;;;......#.##",
    "##........;;;........_......_......T.....................;;;;;;.....................T......_......_........;;;........##",
    "##########;;;#######################...##################;;;;;;##################...#######################;;;##########",
    "##........;;;...T......._...._T........T.................;;;;;;.................T........T_...._.......T...;;;........##",
    "###.......;;;............................................;;;;;;............................................;;;.......###",
    "##........;;;............................................;;;;;;............................................;;;........##",
    "##..............................T.....~~~~~....T....._............_.....T....~~~~~.....T..............................##",
    "###..........;;;;;............Y.......~~~~~....._......................_.....~~~~~.......Y............;;;;;..........###",
    "##....__.....;;;;;........T.T...._.T..~~~~~..................................~~~~~..T._....T.T........;;;;;.....__....##",
    "###._.~~~....;V;V;..~.~.~.~~~...~_...~~~~~~..~....~.....~.~..~.~.....~....~..~~~~~~..._~...~~~.~.~.~..;V;V;....~~~._.###",
    "##..~.~~~~.~~~~~~~~~~~~~~.~~~~~.~~.~~~~~~~~~~~.~..~~~~~~~~~~~~~~~~~~~~..~.~~~~~~~~~~~.~~.~~~~~.~~~~~~~~~~~~~~.~~~~.~..##",
    "##..~~~~~~~~~~~~~~~~~~~~~~~~~~~~~~~~~~~~~~~~~~~~~~~~~~~~~~~~~~~~~~~~~~~~~~~~~~~~~~~~~~~~~~~~~~~~~~~~~~~~~~~~~~~~~~~~..##",
    "##..~~~~~~~~~~~~~~~~~~~~~~~~~~~~~~~~~~~~~~~~~~~~~~~~~~~~~T;;;;T~~~~~~~~~~~~~~~~~~~~~~~~~~~~~~~~~~~~~~~~~~~~~~~~~~~~~..##",
    "###.~~~~~~~~~~~~~~~~~~~~~~~~~~~~~~~~~~~~~~~~~~~~~~~~~~~~~;C;;C;~~~~~~~~~~~~~~~~~~~~~~~~~~~~~~~~~~~~~~~~~~~~~~~~~~~~~.###",
    "##..~~~~~~~~~~~~~~~~~~~~~~~~~~~~~~~~~~~~~~~~~~~~~~~~~~~~~~~~~~~~~~~~~~~~~~~~~~~~~~~~~~~~~~~~~~~~~~~~~~~~~~~~~~~~~~~~..##",
    "###.~~~~~~~.~~.~~~~~~~~~..~~~~~~~~..~~~~..~~..~~~~~~.~~~~~~~~~~~~~~.~~~~~~..~~..~~~~..~~~~~~~~..~~~~~~~~~.~~.~~~~~~~.###",
    "###...~~~.......~~~..._...~.........~._~...~._~.~T._..~_..~..~.._~.._.T~.~_.~...~_.~.........~..._...~~~.......~~~...###",
    "##.........TT......T.T..._....._.T........._......._................_......._.........T._....._...T.T......TT.........##",
    "##.....T....................._...T....................................................T..._.....................T.....##",
    "###~.~..~#T#.#~~..T~#.T#.._.._~#.T_T~..TT.#..~.....~T#............#T~.....~..#.TT..~T_T.#~_.._..#T.#~T..~~#.#T#~..~.~###",
    "##~~~~#.~_~~~#~~..~~~_..~T~.~.~~~T~T#~~~..~~#TT~.~_._~_~.##..##.~_~_._~.~TT#~~..~~~#T~T~~~.~.~T~.._~~~..~~#~~~_~.#~~~~##",
    "##_#~.~...#T.~.~.~_#_~.#.#~~T~__~~#T.~......~~~#.T~....._T~~~~T_.....~T.#~~~......~.T#~~__~T~~#.#.~_#_~.~.~.T#...~.~#_##",
    "########################################################################################################################",
    "########################################################################################################################"
  ]
}
